Script started on 2020-01-30 14:02:32-05:00 [TERM="xterm-256color" TTY="/dev/pts/1" COLUMNS="105" LINES="49"]
bash: /home/umrigar/cs240/bin/student.profile: Permission denied
alongo5@g7-18:/import/linux/home1/alongo5/i240a/submit/lab1$ ls
0-hello  1-monolithic  2-separate-compilation  3-makefile  4-dependencies  5-auto-dependencies	lab1.LOG
alongo5@g7-18:/import/linux/home1/alongo5/i240a/submit/lab1$ cd 1[K1-monolithic/
alongo5@g7-18:/import/linux/home1/alongo5/i240a/submit/lab1/1-monolithic$ cd -0[K[K0[K[K[K[Kxs ../0-hello/
bash: xs: command not found
alongo5@g7-18:/import/linux/home1/alongo5/i240a/submit/lab1/1-monolithic$ cd ..-0[K[K/0-hello/
alongo5@g7-18:/import/linux/home1/alongo5/i240a/submit/lab1/0-hello$ make
make: *** No targets specified and no makefile found.  Stop.
alongo5@g7-18:/import/linux/home1/alongo5/i240a/submit/lab1/0-hello$ ./f[Khello 
hello world
alongo5@g7-18:/import/linux/home1/alongo5/i240a/submit/lab1/0-hello$ cd ../1-monolithic/
alongo5@g7-18:/import/linux/home1/alongo5/i240a/submit/lab1/1-monolithic$ ma[K[Kna[K[Kmake fns-compare
make: 'fns-compare' is up to date.
alongo5@g7-18:/import/linux/home1/alongo5/i240a/submit/lab1/1-monolithic$ ./F[Kfns-compare 
1 100000 1000
10 1e+06 100000
100 1e+07 1e+07
1000 1e+08 1e+09
10000 1e+09 1e+11
alongo5@g7-18:/import/linux/home1/alongo5/i240a/submit/lab1/1-monolithic$ g++ -g -Wall -std=c++17 fns-compare.cc -o fns-compare
alongo5@g7-18:/import/linux/home1/alongo5/i240a/submit/lab1/1-monolithic$ ./fns-compare 
1 100000 1000
10 1e+06 100000
100 1e+07 1e+07
1000 1e+08 1e+09
10000 1e+09 1e+11
alongo5@g7-18:/import/linux/home1/alongo5/i240a/submit/lab1/1-monolithic$ g++ -g -Wall -std=c++17 fns-compare.cc -o fns-comparevi[K[K[K[K[K[K[K[K[K[K[K[K[K[K[K[K[K[K[K[K[K[K[K[K[A[C[C[C[C[C[C[C[C[C[C[C[C[C[C[C[C[C[C[C[C[C[C[C[C[C[C[C[C[C[C[C[C[C[C[C[C[C[C[C[C[C[C[C[C[C[C[C[C[C[C[C[C[C[C[C[C[C[C[C[C[C[C[C[C[C[C[C[C[C[C[C[C[C[C[C[C[C[C[C[C[C[C[C[C[C[C[C[C[C[C[C[C[C[C[C[C[C[C[C[C[C[C[C[C[K
[K[A[C[C[C[C[C[C[C[C[C[C[C[C[C[C[C[C[C[C[C[C[C[C[C[C[C[C[C[C[C[C[C[C[C[C[C[C[C[C[C[C[C[C[C[C[C[C[C[C[C[C[C[C[C[C[C[C[C[C[C[C[C[C[C[C[C[C[C[C[C[C[C[C[C[C[C[C[C[C[C[C[C[C[C[C[C[C[C[C[C[C[C[C[C[C[C[C[C[C[C[C[C[C[C[C[K[K[K[K[K[K[K[K[K[K[K[K[K[K[K[K[K[K[K[K[K[K[K[K[K[K[K[K[K[Kls
fns-compare  fns-compare.cc
alongo5@g7-18:/import/linux/home1/alongo5/i240a/submit/lab1/1-monolithic$ vim fns-compare
[?1000h[?2004h[?1049h[22;0;0t[?1h=[?2004h[1;49r[?12h[?12l[22;2t[22;1t[27m[23m[29m[m[H[2J[?25l[49;1H"fns-compare" [noeol][converted] 89L, 112188C[2;1H▽[6n[2;1H  [1;1H[>c]10;?]11;?[1;1H[34m^?[mELF[34m^B^A^A^@^@^@^@^@^@^@^@^@^C^@[m>[34m^@^A^@^@^@[mp[34m^P^@^@^@^@^@^@[m@[34m^@^@^@^@^@^@^@[m@[34m<95>^A^@^@^@^@^@^@^@^@^@[m@[34m^@[m8[34m^@@[2;1H^K^@[m@[34m^@[m$[34m^@[m#[34m^@^F^@^@^@^D^@^@^@[m@[34m^@^@^@^@^@^@^@[m@[34m^@^@^@^@^@^@^@[m@[34m^@^@^@^@^@^@^@[mh[34m^B^@^@^@^@^@^@[mh[34m^B^@^@^@^@^@^@^^[3;1HH^@^@^@^@^@^@^@^C^@^@^@^D^@^@^@[m¨[3;33H[34m^B^@^@^@^@^@^@[m¨[3;48H[34m^B^@^@^@^@^@^@[m¨[3;63H[34m^B^@^@^@^@^@^@^\^@^@^@^@^@^@^@^\^@^@^@^@^@^^[4;1H@^@^A^@^@^@^@^@^@^@^A^@^@^@^D^@^@^@^@^@^@^@^@^@^@^@^@^@^@^@^@^@^@^@^@^@^@^@^@^@^@^@[mà[4;85H[34m^F^@^@^@^@^@^@[mà[4;100H[34m^F^@^@@[5;1H^@^@^@^@^@^P^@^@^@^@^@^@^A^@^@^@^E^@^@^@^@^P^@^@^@^@^@^@^@^P^@^@^@^@^@^@^@^P^@^@^@^@^@^@<8d>^C^@^@^@^@^@^^[6;1H@<8d>^C^@^@^@^@^@^@^@^P^@^@^@^@^@^@^A^@^@^@^D^@^@^@^@[m [34m^@^@^@^@^@^@^@[m [34m^@^@^@^@^@^@^@[m [34m^@^@^@^@^@^@[mØ[6;98H[34m^B^@^@^@@[7;1H^@^@^@[mØ[7;8H[34m^B^@^@^@^@^@^@^@^P^@^@^@^@^@^@^A^@^@^@^F^@^@^@[m¨[7;55H-[34m^@^@^@^@^@^@[m¨[7;69H=[34m^@^@^@^@^@^@[m¨[7;83H=[34m^@^@^@^@^@^@<98>^B^@^@@[8;1H^@^@^@^@[m¨[8;10H[34m^B^@^@^@^@^@^@^@^P^@^@^@^@^@^@^B^@^@^@^F^@^@^@[mÀ-[34m^@^@^@^@^@^@[mÀ=[34m^@^@^@^@^@^@[mÀ=[34m^@^@^@^@^@^@^P^B^@^@@[9;1H^@^@^@^@^P^B^@^@^@^@^@^@^H^@^@^@^@^@^@^@^D^@^@^@^D^@^@^@[mÄ[34m^B^@^@^@^@^@^@[mÄ[34m^B^@^@^@^@^@^@[mÄ[34m^B^@^@^@^@^@^@[mD[34m^@^^[10;1H@^@^@^@^@^@[mD[34m^@^@^@^@^@^@^@^D^@^@^@^@^@^@^@[mPåtd[34m^D^@^@^@[mx [34m^@^@^@^@^@^@[mx [34m^@^@^@^@^@^@[mx [34m^@^@^@^@^@^@[mt[34m^@^@^@^@@[11;1H^@^@^@[mt[34m^@^@^@^@^@^@^@^D^@^@^@^@^@^@^@[mQåtd[34m^F^@^@^@^@^@^@^@^@^@^@^@^@^@^@^@^@^@^@^@^@^@^@^@^@^@^@^@^@^@^@^@@[12;1H^@^@^@^@^@^@^@^@^@^@^@^@^P^@^@^@^@^@^@^@[mRåtd[34m^D^@^@^@[m¨[12;54H-[34m^@^@^@^@^@^@[m¨[12;68H=[34m^@^@^@^@^@^@[m¨[12;82H=[34m^@^@^@^@^@^@[mX[34m^B^@^@^@^@@[13;1H^@^@[mX[34m^B^@^@^@^@^@^@^A^@^@^@^@^@^@^@[m/lib64/ld-linux-x86-64.so.2[34m^@^D^@^@^@^P^@^@^@^A^@^@^@[mGNU[34m^@^@^@^@^@^C^@@[14;1H^@^@^B^@^@^@^@^@^@^@^D^@^@^@^T^@^@^@^C^@^@^@[mGNU[34m^@<97>[mûmÒ[34m^X[mZ[34m^O[mE§[14;64H/á[14;66H[34m<80>[m6:[34m<82>[mo[34m^X^P[mÞ[14;82Hí[14;83H[34m^B^@^@^@[m [34m^@^@^@^A^@^@^@@[15;1H^F^@^@^@^@^@<81>^@^@^A^P^@[8C^@^@^@^@^@^@^@[m([34m^]<8c>^\[mÑeÎm[34m^@^@^@^@^@^@^@^@^@^@^@^@^@^@^@^@^@^@^@^@^@^@@[16;1H^@^@[m§[16;6H[34m^@^@^@^R^@^@^@^@^@^@^@^@^@^@^@^@^@^@^@^@^@^@^@[m»[34m^@^@^@^R^@^@^@^@^@^@^@^@^@^@^@^@^@^@^@^@^@^@^@[mm[34m^@^@^@@[17;1H^R^@^@^@^@^@^@^@^@^@^@^@^@^@^@^@^@^@^@^@^_^@^@^@[m [34m^@^@^@^@^@^@^@^@^@^@^@^@^@^@^@^@^@^@^@[mÒ[34m^@^@^@^R^@^@^@^@^^[18;1H@^@^@^@^@^@^@^@^@^@^@^@^@^@^@^P^@^@^@[m [34m^@^@^@^@^@^@^@^@^@^@^@^@^@^@^@^@^@^@^@[m;[34m^@^@^@[m [34m^@^@^@^@^@^@^@^@^@^@^^[19;1H@^@^@^@^@^@^@^@^@[mU[34m^@^@^@^R^@^@^@^@^@^@^@^@^@^@^@^@^@^@^@^@^@^@^@[m´[19;66H[34m^@^@^@^Q^@^Y^@[m@@[34m^@^@^@^@^@^@^H^@^@^@^@^@@[20;1H^@^@[mÃ[34m^@^@^@[m"[34m^@^@^@^@^@^@^@^@^@^@^@^@^@^@^@^@^@^@^@^@[mlibstdc++.so.6[34m^@[m__gmon_start__[34m^@[m_ITM_deregisterTMClonn[21;1HeTable[34m^@[m_ITM_registerTMCloneTable[34m^@[m_ZNSt8ios_base4InitD1Ev[34m^@[m_ZNSt8ios_base4InitC1Ev[34m^@[mlibm.so.6[34m^@[mlibgcc_s..[22;1Hso.1[34m^@[mlibc.so.6[34m^@[m__cxa_atexit[34m^@[mstdout[34m^@[mfprintf[34m^@[m__cxa_finalize[34m^@[m__libc_start_main[34m^@[mGLIBCXX_3.4[34m^@[mGLIBC_2.22[23;1H.5[34m^@^@^@^B^@^B^@^C^@^@^@^B^@^@^@^@^@^C^@^B^@^B^@^@^@^@^@^@^@^A^@^A^@^A^@^@^@^P^@^@^@[m [34m^@^@^@[mt)[34m<92>^H^@^@^CC[24;1H^@[mä[34m^@^@^@^@^@^@^@^A^@^A^@<9d>^@^@^@^P^@^@^@^@^@^@^@[mu[34m^Z[mi  [34m^@^@^B^@[mð[24;67H[34m^@^@^@^@^@^@^@[m¨[24;82H=[34m^@^@^@^@^@^@^H^@^@^@^@^^[25;1H@^@^@[mP[34m^Q^@^@^@^@^@^@[m°[25;22H=[34m^@^@^@^@^@^@^H^@^@^@^@^@^@^@[m§[25;52H[34m^R^@^@^@^@^@^@[m¸[25;67H=[34m^@^@^@^@^@^@^H^@^@^@^@^@^@^@^P^Q^@^@^@@[26;1H^@^@^@[m8@[34m^@^@^@^@^@^@^H^@^@^@^@^@^@^@[m8@[34m^@^@^@^@^@^@[mÐ[26;52H?[34m^@^@^@^@^@^@^F^@^@^@
^@^@^@^@^@^@^@^@^@^@^@[mØ[27;24H?[34m^@^@^@^@^@^@^F^@^@^@^D^@^@^@^@^@^@^@^@^@^@^@[mà[27;70H?[34m^@^@^@^@^@^@^F^@^@^@^E^@^@^@^@^@^@^^[28;1H@^@^@^@^@[mè[28;11H?[34m^@^@^@^@^@^@^F^@^@^@^F^@^@^@^@^@^@^@^@^@^@^@[mð[28;57H?[34m^@^@^@^@^@^@^F^@^@^@^G^@^@^@^@^@^@^@^@^@^@^@[mø[28;103H?[34m^@@[29;1H^@^@^@^@^@^F^@^@^@^H^@^@^@^@^@^@^@^@^@^@^@[m@@[34m^@^@^@^@^@^@^E^@^@^@[m      [34m^@^@^@^@^@^@^@^@^@^@^@^X[m@[34m^@^@^@^@^@@[30;1H^@^G^@^@^@^A^@^@^@^@^@^@^@^@^@^@^@[m @[34m^@^@^@^@^@^@^G^@^@^@^B^@^@^@^@^@^@^@^@^@^@^@[m(@[34m^@^@^@^@^@^@^G^@^@^@^C^^[31;1H@^@^@^@^@^@^@^@^@^@^@^@^@^@^@^@^@^@^@^@^@^@^@^@^@^@^@^@^@^@^@^@^@^@^@^@^@^@^@^@^@^@^@^@^@^@^@^@^@^@^@^@^@@[32;1H^@^@^@^@^@^@^@^@^@^@^@^@^@^@^@^@^@^@^@^@^@^@^@^@^@^@^@^@^@^@^@^@^@^@^@^@^@^@^@^@^@^@^@^@^@^@^@^@^@^@^@^@^^[33;1H@^@^@^@^@^@^@^@^@^@^@^@^@^@^@^@^@^@^@^@^@^@^@^@^@^@^@^@^@^@^@^@^@^@^@^@^@^@^@^@^@^@^@^@^@^@^@^@^@^@^@^@^@@[34;1H^@^@^@^@^@^@^@^@^@^@^@^@^@^@^@^@^@^@^@^@^@^@^@^@^@^@^@^@^@^@^@^@^@^@^@^@^@^@^@^@^@^@^@^@^@^@^@^@^@^@^@^@^^[35;1H@^@^@^@^@^@^@^@^@^@^@^@^@^@^@^@^@^@^@^@^@^@^@^@^@^@^@^@^@^@^@^@^@^@^@^@^@^@^@^@^@^@^@^@^@^@^@^@^@^@^@^@^@@[36;1H^@^@^@^@^@^@^@^@^@^@^@^@^@^@^@^@^@^@^@^@^@^@^@^@^@^@^@^@^@^@^@^@^@^@^@^@^@^@^@^@^@^@^@^@^@^@^@^@^@^@^@^@^^[37;1H@^@^@^@^@^@^@^@^@^@^@^@^@^@^@^@^@^@^@^@^@^@^@^@^@^@^@^@^@^@^@^@^@^@^@^@^@^@^@^@^@^@^@^@^@^@^@^@^@^@^@^@^@@[38;1H^@^@^@^@^@^@^@^@^@^@^@^@^@^@^@^@^@^@^@^@^@^@^@^@^@^@^@^@^@^@^@^@^@^@^@^@^@^@^@^@^@^@^@^@^@^@^@^@^@^@^@^@^^[39;1H@^@^@^@^@^@^@^@^@^@^@^@^@^@^@^@^@^@^@^@^@^@^@^@^@^@^@^@^@^@^@^@^@^@^@^@^@^@^@^@^@^@^@^@^@^@^@^@^@^@^@^@^@@[40;1H^@^@^@^@^@^@^@^@^@^@^@^@^@^@^@^@^@^@^@^@^@^@^@^@^@^@^@^@^@^@^@^@^@^@^@^@^@^@^@^@^@^@^@^@^@^@^@^@^@^@^@^@^^[41;1H@^@^@^@^@^@^@^@^@^@^@^@^@^@^@^@^@^@^@^@^@^@^@^@^@^@^@^@^@^@^@^@^@^@^@^@^@^@^@^@^@^@^@^@^@^@^@^@^@^@^@^@^@@[42;1H^@^@^@^@^@^@^@^@^@^@^@^@^@^@^@^@^@^@^@^@^@^@^@^@^@^@^@^@^@^@^@^@^@^@^@^@^@^@^@^@^@^@^@^@^@^@^@^@^@^@^@^@^^[43;1H@^@^@^@^@^@^@^@^@^@^@^@^@^@^@^@^@^@^@^@^@^@^@^@^@^@^@^@^@^@^@^@^@^@^@^@^@^@^@^@^@^@^@^@^@^@^@^@^@^@^@^@^@@[44;1H^@^@^@^@^@^@^@^@^@^@^@^@^@^@^@^@^@^@^@^@^@^@^@^@^@^@^@^@^@^@^@^@^@^@^@^@^@^@^@^@^@^@^@^@^@^@^@^@^@^@^@^@^^[45;1H@^@^@^@^@^@^@^@^@^@^@^@^@^@^@^@^@^@^@^@^@^@^@^@^@^@^@^@^@^@^@^@^@^@^@^@^@^@^@^@^@^@^@^@^@^@^@^@^@^@^@^@^@@[46;1H^@^@^@^@^@^@^@^@^@^@^@^@^@^@^@^@^@^@^@^@^@^@^@^@^@^@^@^@^@^@^@^@^@^@^@^@^@^@^@^@^@^@^@^@^@^@^@^@^@^@^@^@^^[47;1H@^@^@^@^@^@^@^@^@^@^@^@^@^@^@^@^@^@^@^@^@^@^@^@^@^@^@^@^@^@^@^@^@^@^@^@^@^@^@^@^@^@^@^@^@^@^@^@^@^@^@^@^@@[48;1H^@^@^@^@^@^@^@^@^@^@^@^@^@^@^@^@^@^@^@^@^@^@^@^@^@^@^@^@^@^@^@^@^@^@^@^@^@^@^@^@^@^@^@^@^@^@^@^@^@^@^@^@^[m[48;1H[94m@@@                                                                                                      [m[49;88H1,1[11CTop]2;fns-compare (~/projects/i240a/submit/lab1/1-monolithic) - VIM]1;fns-compare[1;1H[?25hP+q436f\P+q6b75\P+q6b64\P+q6b72\P+q6b6c\P+q2332\P+q2334\P+q2569\P+q2a37\P+q6b31\[?1000l[?1006h[?1002h[?1006l[?1002l[?1006h[?1002h[27m[23m[29m[m[H[2J[?25l[1;1H[38;5;81m^?[mELF[38;5;81m^B^A^A^@^@^@^@^@^@^@^@^@^C^@[m>[38;5;81m^@^A^@^@^@[mp[38;5;81m^P^@^@^@^@^@^@[m@[38;5;81m^@^@^@^@^@^@^@[m@[38;5;81m<95>^A^@^@^@^@^@^@^@^@^@[m@[38;5;81m^@[m8[38;5;81m^@@[2;1H^K^@[m@[38;5;81m^@[m$[38;5;81m^@[m#[38;5;81m^@^F^@^@^@^D^@^@^@[m@[38;5;81m^@^@^@^@^@^@^@[m@[38;5;81m^@^@^@^@^@^@^@[m@[38;5;81m^@^@^@^@^@^@^@[mh[38;5;81m^B^@^@^@^@^@^@[mh[38;5;81m^B^@^@^@^@^@^@^^[3;1HH^@^@^@^@^@^@^@^C^@^@^@^D^@^@^@[m¨[3;33H[38;5;81m^B^@^@^@^@^@^@[m¨[3;48H[38;5;81m^B^@^@^@^@^@^@[m¨[3;63H[38;5;81m^B^@^@^@^@^@^@^\^@^@^@^@^@^@^@^\^@^@^@^@^@^^[4;1H@^@^A^@^@^@^@^@^@^@^A^@^@^@^D^@^@^@^@^@^@^@^@^@^@^@^@^@^@^@^@^@^@^@^@^@^@^@^@^@^@^@[mà[4;85H[38;5;81m^F^@^@^@^@^@^@[mà[4;100H[38;5;81m^F^@^@@[5;1H^@^@^@^@^@^P^@^@^@^@^@^@^A^@^@^@^E^@^@^@^@^P^@^@^@^@^@^@^@^P^@^@^@^@^@^@^@^P^@^@^@^@^@^@<8d>^C^@^@^@^@^@^^[6;1H@<8d>^C^@^@^@^@^@^@^@^P^@^@^@^@^@^@^A^@^@^@^D^@^@^@^@[m [38;5;81m^@^@^@^@^@^@^@[m [38;5;81m^@^@^@^@^@^@^@[m [38;5;81m^@^@^@^@^@^@[mØ[6;98H[38;5;81m^B^@^@^@@[7;1H^@^@^@[mØ[7;8H[38;5;81m^B^@^@^@^@^@^@^@^P^@^@^@^@^@^@^A^@^@^@^F^@^@^@[m¨[7;55H-[38;5;81m^@^@^@^@^@^@[m¨[7;69H=[38;5;81m^@^@^@^@^@^@[m¨[7;83H=[38;5;81m^@^@^@^@^@^@<98>^B^@^@@[8;1H^@^@^@^@[m¨[8;10H[38;5;81m^B^@^@^@^@^@^@^@^P^@^@^@^@^@^@^B^@^@^@^F^@^@^@[mÀ-[38;5;81m^@^@^@^@^@^@[mÀ=[38;5;81m^@^@^@^@^@^@[mÀ=[38;5;81m^@^@^@^@^@^@^P^B^@^@@[9;1H^@^@^@^@^P^B^@^@^@^@^@^@^H^@^@^@^@^@^@^@^D^@^@^@^D^@^@^@[mÄ[38;5;81m^B^@^@^@^@^@^@[mÄ[38;5;81m^B^@^@^@^@^@^@[mÄ[38;5;81m^B^@^@^@^@^@^@[mD[38;5;81m^@^^[10;1H@^@^@^@^@^@[mD[38;5;81m^@^@^@^@^@^@^@^D^@^@^@^@^@^@^@[mPåtd[38;5;81m^D^@^@^@[mx [38;5;81m^@^@^@^@^@^@[mx [38;5;81m^@^@^@^@^@^@[mx [38;5;81m^@^@^@^@^@^@[mt[38;5;81m^@^@^@^@@[11;1H^@^@^@[mt[38;5;81m^@^@^@^@^@^@^@^D^@^@^@^@^@^@^@[mQåtd[38;5;81m^F^@^@^@^@^@^@^@^@^@^@^@^@^@^@^@^@^@^@^@^@^@^@^@^@^@^@^@^@^@^@^@@[12;1H^@^@^@^@^@^@^@^@^@^@^@^@^P^@^@^@^@^@^@^@[mRåtd[38;5;81m^D^@^@^@[m¨[12;54H-[38;5;81m^@^@^@^@^@^@[m¨[12;68H=[38;5;81m^@^@^@^@^@^@[m¨[12;82H=[38;5;81m^@^@^@^@^@^@[mX[38;5;81m^B^@^@^@^@@[13;1H^@^@[mX[38;5;81m^B^@^@^@^@^@^@^A^@^@^@^@^@^@^@[m/lib64/ld-linux-x86-64.so.2[38;5;81m^@^D^@^@^@^P^@^@^@^A^@^@^@[mGNU[38;5;81m^@^@^@^@^@^C^@@[14;1H^@^@^B^@^@^@^@^@^@^@^D^@^@^@^T^@^@^@^C^@^@^@[mGNU[38;5;81m^@<97>[mûmÒ[38;5;81m^X[mZ[38;5;81m^O[mE§[14;64H/á[14;66H[38;5;81m<80>[m6:[38;5;81m<82>[mo[38;5;81m^X^P[mÞ[14;82Hí[14;83H[38;5;81m^B^@^@^@[m [38;5;81m^@^@^@^A^@^@^@@[15;1H^F^@^@^@^@^@<81>^@^@^A^P^@[8C^@^@^@^@^@^@^@[m([38;5;81m^]<8c>^\[mÑeÎm[38;5;81m^@^@^@^@^@^@^@^@^@^@^@^@^@^@^@^@^@^@^@^@^@^@@[16;1H^@^@[m§[16;6H[38;5;81m^@^@^@^R^@^@^@^@^@^@^@^@^@^@^@^@^@^@^@^@^@^@^@[m»[38;5;81m^@^@^@^R^@^@^@^@^@^@^@^@^@^@^@^@^@^@^@^@^@^@^@[mm[38;5;81m^@^@^@@[17;1H^R^@^@^@^@^@^@^@^@^@^@^@^@^@^@^@^@^@^@^@^_^@^@^@[m [38;5;81m^@^@^@^@^@^@^@^@^@^@^@^@^@^@^@^@^@^@^@[mÒ[38;5;81m^@^@^@^R^@^@^@^@^^[18;1H@^@^@^@^@^@^@^@^@^@^@^@^@^@^@^P^@^@^@[m [38;5;81m^@^@^@^@^@^@^@^@^@^@^@^@^@^@^@^@^@^@^@[m;[38;5;81m^@^@^@[m [38;5;81m^@^@^@^@^@^@^@^@^@^@^^[19;1H@^@^@^@^@^@^@^@^@[mU[38;5;81m^@^@^@^R^@^@^@^@^@^@^@^@^@^@^@^@^@^@^@^@^@^@^@[m´[19;66H[38;5;81m^@^@^@^Q^@^Y^@[m@@[38;5;81m^@^@^@^@^@^@^H^@^@^@^@^@@[20;1H^@^@[mÃ[38;5;81m^@^@^@[m"[38;5;81m^@^@^@^@^@^@^@^@^@^@^@^@^@^@^@^@^@^@^@^@[mlibstdc++.so.6[38;5;81m^@[m__gmon_start__[38;5;81m^@[m_ITM_deregisterTMClonn[21;1HeTable[38;5;81m^@[m_ITM_registerTMCloneTable[38;5;81m^@[m_ZNSt8ios_base4InitD1Ev[38;5;81m^@[m_ZNSt8ios_base4InitC1Ev[38;5;81m^@[mlibm.so.6[38;5;81m^@[mlibgcc_s..[22;1Hso.1[38;5;81m^@[mlibc.so.6[38;5;81m^@[m__cxa_atexit[38;5;81m^@[mstdout[38;5;81m^@[mfprintf[38;5;81m^@[m__cxa_finalize[38;5;81m^@[m__libc_start_main[38;5;81m^@[mGLIBCXX_3.4[38;5;81m^@[mGLIBC_2.22[23;1H.5[38;5;81m^@^@^@^B^@^B^@^C^@^@^@^B^@^@^@^@^@^C^@^B^@^B^@^@^@^@^@^@^@^A^@^A^@^A^@^@^@^P^@^@^@[m [38;5;81m^@^@^@[mt)[38;5;81m<92>^H^@^@^CC[24;1H^@[mä[38;5;81m^@^@^@^@^@^@^@^A^@^A^@<9d>^@^@^@^P^@^@^@^@^@^@^@[mu[38;5;81m^Z[mi  [38;5;81m^@^@^B^@[mð[24;67H[38;5;81m^@^@^@^@^@^@^@[m¨[24;82H=[38;5;81m^@^@^@^@^@^@^H^@^@^@^@^^[25;1H@^@^@[mP[38;5;81m^Q^@^@^@^@^@^@[m°[25;22H=[38;5;81m^@^@^@^@^@^@^H^@^@^@^@^@^@^@[m§[25;52H[38;5;81m^R^@^@^@^@^@^@[m¸[25;67H=[38;5;81m^@^@^@^@^@^@^H^@^@^@^@^@^@^@^P^Q^@^@^@@[26;1H^@^@^@[m8@[38;5;81m^@^@^@^@^@^@^H^@^@^@^@^@^@^@[m8@[38;5;81m^@^@^@^@^@^@[mÐ[26;52H?[38;5;81m^@^@^@^@^@^@^F^@^@^@
^@^@^@^@^@^@^@^@^@^@^@[mØ[27;24H?[38;5;81m^@^@^@^@^@^@^F^@^@^@^D^@^@^@^@^@^@^@^@^@^@^@[mà[27;70H?[38;5;81m^@^@^@^@^@^@^F^@^@^@^E^@^@^@^@^@^@^^[28;1H@^@^@^@^@[mè[28;11H?[38;5;81m^@^@^@^@^@^@^F^@^@^@^F^@^@^@^@^@^@^@^@^@^@^@[mð[28;57H?[38;5;81m^@^@^@^@^@^@^F^@^@^@^G^@^@^@^@^@^@^@^@^@^@^@[mø[28;103H?[38;5;81m^@@[29;1H^@^@^@^@^@^F^@^@^@^H^@^@^@^@^@^@^@^@^@^@^@[m@@[38;5;81m^@^@^@^@^@^@^E^@^@^@[m      [38;5;81m^@^@^@^@^@^@^@^@^@^@^@^X[m@[38;5;81m^@^@^@^@^@@[30;1H^@^G^@^@^@^A^@^@^@^@^@^@^@^@^@^@^@[m @[38;5;81m^@^@^@^@^@^@^G^@^@^@^B^@^@^@^@^@^@^@^@^@^@^@[m(@[38;5;81m^@^@^@^@^@^@^G^@^@^@^C^^[31;1H@^@^@^@^@^@^@^@^@^@^@^@^@^@^@^@^@^@^@^@^@^@^@^@^@^@^@^@^@^@^@^@^@^@^@^@^@^@^@^@^@^@^@^@^@^@^@^@^@^@^@^@^@@[32;1H^@^@^@^@^@^@^@^@^@^@^@^@^@^@^@^@^@^@^@^@^@^@^@^@^@^@^@^@^@^@^@^@^@^@^@^@^@^@^@^@^@^@^@^@^@^@^@^@^@^@^@^@^^[33;1H@^@^@^@^@^@^@^@^@^@^@^@^@^@^@^@^@^@^@^@^@^@^@^@^@^@^@^@^@^@^@^@^@^@^@^@^@^@^@^@^@^@^@^@^@^@^@^@^@^@^@^@^@@[34;1H^@^@^@^@^@^@^@^@^@^@^@^@^@^@^@^@^@^@^@^@^@^@^@^@^@^@^@^@^@^@^@^@^@^@^@^@^@^@^@^@^@^@^@^@^@^@^@^@^@^@^@^@^^[35;1H@^@^@^@^@^@^@^@^@^@^@^@^@^@^@^@^@^@^@^@^@^@^@^@^@^@^@^@^@^@^@^@^@^@^@^@^@^@^@^@^@^@^@^@^@^@^@^@^@^@^@^@^@@[36;1H^@^@^@^@^@^@^@^@^@^@^@^@^@^@^@^@^@^@^@^@^@^@^@^@^@^@^@^@^@^@^@^@^@^@^@^@^@^@^@^@^@^@^@^@^@^@^@^@^@^@^@^@^^[37;1H@^@^@^@^@^@^@^@^@^@^@^@^@^@^@^@^@^@^@^@^@^@^@^@^@^@^@^@^@^@^@^@^@^@^@^@^@^@^@^@^@^@^@^@^@^@^@^@^@^@^@^@^@@[38;1H^@^@^@^@^@^@^@^@^@^@^@^@^@^@^@^@^@^@^@^@^@^@^@^@^@^@^@^@^@^@^@^@^@^@^@^@^@^@^@^@^@^@^@^@^@^@^@^@^@^@^@^@^^[39;1H@^@^@^@^@^@^@^@^@^@^@^@^@^@^@^@^@^@^@^@^@^@^@^@^@^@^@^@^@^@^@^@^@^@^@^@^@^@^@^@^@^@^@^@^@^@^@^@^@^@^@^@^@@[40;1H^@^@^@^@^@^@^@^@^@^@^@^@^@^@^@^@^@^@^@^@^@^@^@^@^@^@^@^@^@^@^@^@^@^@^@^@^@^@^@^@^@^@^@^@^@^@^@^@^@^@^@^@^^[41;1H@^@^@^@^@^@^@^@^@^@^@^@^@^@^@^@^@^@^@^@^@^@^@^@^@^@^@^@^@^@^@^@^@^@^@^@^@^@^@^@^@^@^@^@^@^@^@^@^@^@^@^@^@@[42;1H^@^@^@^@^@^@^@^@^@^@^@^@^@^@^@^@^@^@^@^@^@^@^@^@^@^@^@^@^@^@^@^@^@^@^@^@^@^@^@^@^@^@^@^@^@^@^@^@^@^@^@^@^^[43;1H@^@^@^@^@^@^@^@^@^@^@^@^@^@^@^@^@^@^@^@^@^@^@^@^@^@^@^@^@^@^@^@^@^@^@^@^@^@^@^@^@^@^@^@^@^@^@^@^@^@^@^@^@@[44;1H^@^@^@^@^@^@^@^@^@^@^@^@^@^@^@^@^@^@^@^@^@^@^@^@^@^@^@^@^@^@^@^@^@^@^@^@^@^@^@^@^@^@^@^@^@^@^@^@^@^@^@^@^^[45;1H@^@^@^@^@^@^@^@^@^@^@^@^@^@^@^@^@^@^@^@^@^@^@^@^@^@^@^@^@^@^@^@^@^@^@^@^@^@^@^@^@^@^@^@^@^@^@^@^@^@^@^@^@@[46;1H^@^@^@^@^@^@^@^@^@^@^@^@^@^@^@^@^@^@^@^@^@^@^@^@^@^@^@^@^@^@^@^@^@^@^@^@^@^@^@^@^@^@^@^@^@^@^@^@^@^@^@^@^^[47;1H@^@^@^@^@^@^@^@^@^@^@^@^@^@^@^@^@^@^@^@^@^@^@^@^@^@^@^@^@^@^@^@^@^@^@^@^@^@^@^@^@^@^@^@^@^@^@^@^@^@^@^@^@@[48;1H^@^@^@^@^@^@^@^@^@^@^@^@^@^@^@^@^@^@^@^@^@^@^@^@^@^@^@^@^@^@^@^@^@^@^@^@^@^@^@^@^@^@^@^@^@^@^@^@^@^@^@^@^[m[48;1H[94m@@@                                                                                                      [m[49;88H1,1[11CTop"fns-compare" [noeol][converted] 89L, 112188C[1;1H[?25h[?25l[49;78H^[[1;1H[49;78H  [1;1H[49;78H^[[1;1H[49;78H  [1;1H[?25h[?25l[49;78H:[1;1H[49;1H[K[49;1H:[?2004h[?25hw[?25l[?25hq[?25l[?25h[?25l[?1006l[?1002l[?2004l"fns-compare" [converted] 89L, 112189C written]2;Terminal - ]1;Terminal - [23;2t[23;1t[22;2t[22;1t[23;2t[23;1t
[?2004l[?1l>[?25h[?1049l[23;0;0talongo5@g7-18:/import/linux/home1/alongo5/i240a/submit/lab1/1-monolithic$ vim fns-compare.cc 
[?1000h[?2004h[?1049h[22;0;0t[?1h=[?2004h[1;49r[?12h[?12l[22;2t[22;1t[27m[23m[29m[m[H[2J[?25l[49;1H"fns-compare.cc" 25L, 339C[2;1H▽[6n[2;1H  [1;1H[>c]10;?]11;?[1;1H[35m#include [m[31m<iostream>[m

[32mstatic[m [32mdouble[m
linear([32mdouble[m n)
{
  [32mconst[m [32mdouble[m C = [31m1e5[m;
  [38;5;130mreturn[m C*n;
}

[32mstatic[m [32mdouble[m
quadratic([32mdouble[m n)
{
  [32mconst[m [32mdouble[m C = [31m1e3[m;
  [38;5;130mreturn[m C*n*n;
}


[32mint[m
main() {
  [32mFILE[m *[32mconst[m out = [31mstdout[m;
  [38;5;130mfor[m ([32mauto[m n : { [31m1.0[m, [31m10.0[m, [31m100.0[m, [31m1000.0[m, [31m10000.0[m }) {
    fprintf(out, [31m"[m[35m%g[m[31m [m[35m%g[m[31m [m[35m%g\n[m[31m"[m, n, linear(n),quadratic(n));
  }
}

[94m~                                                                                                        [27;1H~                                                                                                        [28;1H~                                                                                                        [29;1H~                                                                                                        [30;1H~                                                                                                        [31;1H~                                                                                                        [32;1H~                                                                                                        [33;1H~                                                                                                        [34;1H~                                                                                                        [35;1H~                                                                                                        [36;1H~                                                                                                        [37;1H~                                                                                                        [38;1H~                                                                                                        [39;1H~                                                                                                        [40;1H~                                                                                                        [41;1H~                                                                                                        [42;1H~                                                                                                        [43;1H~                                                                                                        [44;1H~                                                                                                        [45;1H~                                                                                                        [46;1H~                                                                                                        [47;1H~                                                                                                        [48;1H~                                                                                                        [m[49;88H22,28[9CAll]2;fns-compare.cc (~/projects/i240a/submit/lab1/1-monolithic) - VIM]1;fns-compare.cc[22;28H[?25hP+q436f\P+q6b75\P+q6b64\P+q6b72\P+q6b6c\P+q2332\P+q2334\P+q2569\P+q2a37\P+q6b31\[?1000l[?1006h[?1002h[?1006l[?1002l[?1006h[?1002h[27m[23m[29m[m[H[2J[?25l[1;1H[38;5;81m#include [m[95m<iostream>[m

[38;5;121mstatic[m [38;5;121mdouble[m
linear([38;5;121mdouble[m n)
{
  [38;5;121mconst[m [38;5;121mdouble[m C = [95m1e5[m;
  [93mreturn[m C*n;
}

[38;5;121mstatic[m [38;5;121mdouble[m
quadratic([38;5;121mdouble[m n)
{
  [38;5;121mconst[m [38;5;121mdouble[m C = [95m1e3[m;
  [93mreturn[m C*n*n;
}


[38;5;121mint[m
main() {
  [38;5;121mFILE[m *[38;5;121mconst[m out = [95mstdout[m;
  [93mfor[m ([38;5;121mauto[m n : { [95m1.0[m, [95m10.0[m, [95m100.0[m, [95m1000.0[m, [95m10000.0[m }) {
    fprintf(out, [95m"[m[38;5;224m%g[m[95m [m[38;5;224m%g[m[95m [m[38;5;224m%g\n[m[95m"[m, n, linear(n),quadratic(n));
  }
}

[94m~                                                                                                        [27;1H~                                                                                                        [28;1H~                                                                                                        [29;1H~                                                                                                        [30;1H~                                                                                                        [31;1H~                                                                                                        [32;1H~                                                                                                        [33;1H~                                                                                                        [34;1H~                                                                                                        [35;1H~                                                                                                        [36;1H~                                                                                                        [37;1H~                                                                                                        [38;1H~                                                                                                        [39;1H~                                                                                                        [40;1H~                                                                                                        [41;1H~                                                                                                        [42;1H~                                                                                                        [43;1H~                                                                                                        [44;1H~                                                                                                        [45;1H~                                                                                                        [46;1H~                                                                                                        [47;1H~                                                                                                        [48;1H~                                                                                                        [m[49;88H22,28[9CAll"fns-compare.cc" 25L, 339C[22;28H[?25h[?25l[49;78H~@k[22;28H[49;78H   [23;3H[21;56H[46m{

[m  [46m}[m[49;89H3,3 [23;3H[?25h[?25l[49;78H~@k[23;3H[49;78H   [24;1H[19;8H[46m{[m[21;56H{

  }
[46m}[m[49;89H4,1[24;1H[?25h[?25l[49;78H~@k[24;1H[49;78H   [25;1H[19;8H{[24;1H}[49;89H5,0-1[25;1H[?25h[?25l[49;78H~@k[25;1H[49;78H   [25;1H[?25h[?25l[49;78H~@k[25;1H[49;78H   [25;1H[?25h[?25l[49;78H~@k[25;1H[49;78H   [25;1H[?25h[?25l[49;78H~@k[25;1H[49;78H   [25;1H[?25h[?25l[49;78H~@k[25;1H[49;78H   [25;1H[?25h[?25l[49;78H~@k[25;1H[49;78H   [24;1H[19;8H[46m{[24;1H}[m[49;89H4,1  [24;1H[?25h[?25l[49;78H~@k[24;1H[49;78H   [23;3H[19;8H{[21;56H[46m{

[m  [46m}[m
}[49;89H3,3[23;3H[?25h[?25l[49;78H~@k[23;3H[49;78H   [22;3H[21;56H{

  }[49;89H2[22;3H[?25h[?25l[49;78H~@k[22;3H[49;78H   [21;3H[49;89H1[21;3H[?25h[?25l[49;78H~@k[21;3H[49;78H   [20;3H[49;89H0[20;3H[?25h[?25l[49;78H~@k[20;3H[49;78H   [21;3H[49;89H1[21;3H[?25h[?25l[49;78H~@k[21;3H[49;78H   [22;3H[49;89H2[22;3H[?25h[?25l[49;78H~@k[22;3H[49;78H   [21;3H[49;89H1[21;3H[?25h[?25l[49;78H^[[21;3H[49;78H  [21;3H[49;78H^[[21;3H[49;78H  [21;3H[?25h[?25l[49;78H:[21;3H[49;1H[K[49;1H:[?2004h[?25hw[?25l[?25hq[?25l[?25h[?25l[?1006l[?1002l[?2004l"fns-compare.cc" 25L, 339C written]2;Terminal - ]1;Terminal - [23;2t[23;1t[22;2t[22;1t[23;2t[23;1t
[?2004l[?1l>[?25h[?1049l[23;0;0talongo5@g7-18:/import/linux/home1/alongo5/i240a/submit/lab1/1-monolithic$ vim fns-compare.cc [Kls[K./fns-compare g++ -g -Wall -std=c++17 fns-compare.cc -o fns-compare
alongo5@g7-18:/import/linux/home1/alongo5/i240a/submit/lab1/1-monolithic$ ./fns-compare 
1 100000 1000
10 1e+06 100000
100 1e+07 1e+07
1000 1e+08 1e+09
10000 1e+09 1e+11
alongo5@g7-18:/import/linux/home1/alongo5/i240a/submit/lab1/1-monolithic$ cd ../2-separate-compilation/
alongo5@g7-18:/import/linux/home1/alongo5/i240a/submit/lab1/2-separate-compilation$ ls
fns-compare	fns-compare.hh	linear.cc  quadratic.cc
fns-compare.cc	fns-compare.o	linear.o   quadratic.o
alongo5@g7-18:/import/linux/home1/alongo5/i240a/submit/lab1/2-separate-compilation$ vim fns-compare.hh 
[?1000h[?2004h[?1049h[22;0;0t[?1h=[?2004h[1;49r[?12h[?12l[22;2t[22;1t[27m[23m[29m[m[H[2J[?25l[49;1H"fns-compare.hh" 14L, 237C[2;1H▽[6n[2;1H  [1;1H[>c]10;?]11;?[1;1H[35m#ifndef FNS_COMPARE_H_
#define FNS_COMPARE_H_[m

[32mtypedef[m [32mdouble[m FN([32mdouble[m);

[32mstruct[m FnInfo {
  FnInfo([32mconst[m [32mchar[m *descr, FN *fn) : descr(descr), fn(fn) { }
  [32mconst[m [32mchar[m *descr;
  FN *fn;
};

[32mbool[m register_fn([32mconst[m FnInfo fnInfo);

[35m#endif[m
[94m~                                                                                                        [16;1H~                                                                                                        [17;1H~                                                                                                        [18;1H~                                                                                                        [19;1H~                                                                                                        [20;1H~                                                                                                        [21;1H~                                                                                                        [22;1H~                                                                                                        [23;1H~                                                                                                        [24;1H~                                                                                                        [25;1H~                                                                                                        [26;1H~                                                                                                        [27;1H~                                                                                                        [28;1H~                                                                                                        [29;1H~                                                                                                        [30;1H~                                                                                                        [31;1H~                                                                                                        [32;1H~                                                                                                        [33;1H~                                                                                                        [34;1H~                                                                                                        [35;1H~                                                                                                        [36;1H~                                                                                                        [37;1H~                                                                                                        [38;1H~                                                                                                        [39;1H~                                                                                                        [40;1H~                                                                                                        [41;1H~                                                                                                        [42;1H~                                                                                                        [43;1H~                                                                                                        [44;1H~                                                                                                        [45;1H~                                                                                                        [46;1H~                                                                                                        [47;1H~                                                                                                        [48;1H~                                                                                                        [m[49;88H14,6[10CAll]2;fns-compare.hh (~/projects/i240a/submit/lab1/2-separate-compilation) - VIM]1;fns-compare.hh[14;6H[?25hP+q436f\P+q6b75\P+q6b64\P+q6b72\P+q6b6c\P+q2332\P+q2334\P+q2569\P+q2a37\P+q6b31\[?1000l[?1006h[?1002h[?1006l[?1002l[?1006h[?1002h[27m[23m[29m[m[H[2J[?25l[1;1H[38;5;81m#ifndef FNS_COMPARE_H_
#define FNS_COMPARE_H_[m

[38;5;121mtypedef[m [38;5;121mdouble[m FN([38;5;121mdouble[m);

[38;5;121mstruct[m FnInfo {
  FnInfo([38;5;121mconst[m [38;5;121mchar[m *descr, FN *fn) : descr(descr), fn(fn) { }
  [38;5;121mconst[m [38;5;121mchar[m *descr;
  FN *fn;
};

[38;5;121mbool[m register_fn([38;5;121mconst[m FnInfo fnInfo);

[38;5;81m#endif[m
[94m~                                                                                                        [16;1H~                                                                                                        [17;1H~                                                                                                        [18;1H~                                                                                                        [19;1H~                                                                                                        [20;1H~                                                                                                        [21;1H~                                                                                                        [22;1H~                                                                                                        [23;1H~                                                                                                        [24;1H~                                                                                                        [25;1H~                                                                                                        [26;1H~                                                                                                        [27;1H~                                                                                                        [28;1H~                                                                                                        [29;1H~                                                                                                        [30;1H~                                                                                                        [31;1H~                                                                                                        [32;1H~                                                                                                        [33;1H~                                                                                                        [34;1H~                                                                                                        [35;1H~                                                                                                        [36;1H~                                                                                                        [37;1H~                                                                                                        [38;1H~                                                                                                        [39;1H~                                                                                                        [40;1H~                                                                                                        [41;1H~                                                                                                        [42;1H~                                                                                                        [43;1H~                                                                                                        [44;1H~                                                                                                        [45;1H~                                                                                                        [46;1H~                                                                                                        [47;1H~                                                                                                        [48;1H~                                                                                                        [m[49;88H14,6[10CAll"fns-compare.hh" 14L, 237C[14;6H[?25h[?25l[49;78H:[14;6H[49;1H[K[49;1H:[?2004h[?25hw[?25l[?25hq[?25l[?25h[?25l[?1006l[?1002l[?2004l"fns-compare.hh" 14L, 237C written]2;Terminal - ]1;Terminal - [23;2t[23;1t[22;2t[22;1t[23;2t[23;1t
[?2004l[?1l>[?25h[?1049l[23;0;0talongo5@g7-18:/import/linux/home1/alongo5/i240a/submit/lab1/2-separate-compilation$ g++ -g -Wall -std=c++17 -c fns-compare.cc
alongo5@g7-18:/import/linux/home1/alongo5/i240a/submit/lab1/2-separate-compilation$  g++ -g -Wall -std=c++17 -c linear.cc[A[C[C[C[C[C[C[C[C[C[C[C[C[C[C[C[C[C[C[C[C[C[C[C[C[C[C[C[C[C[C[C[C[C[C[C[C[C[C[C[C[C[C[C[C[C[C[C[C[C[C[C[C[C[C[C[C[C[C[C[C[C[C[C[C[C[C[C[Cg++ -g -Wall -std=c++17 -c fns-compare.cc[A[C[C[C[C[C[C[C[C[C[C[C[C[C[C[C[C[C[C[C[C[C[C[C[C[C[C[C[C[C[C[C[C[C[C[C[C[C[C[C[C[C[C[C[C[C[C[C[C[C[C[C[C[C[C[C[C[C[C[C[C[C[C[C[C[2Pvim fns-compare.hh 
[K[A[C[C[C[C[C[C[C[C[C[C[C[C[C[C[C[C[C[C[C[C[C[C[C[C[C[C[C[C[C[C[C[C[C[C[C[C[C[C[C[C[C[C[C[C[C[C[C[C[C[C[C[C[C[C[C[C[C[C[C[C[C[C[C[C[C[C[C[C[C[C[C[C[C[C[C[C[C[C[C[C[C[C[C[C[C[C[C[C[C[C[C[C[C[C[C[C[C[C[C[C[C[C[Cg++ -g -Wall -std=c++17 -c fns-compare.cc[A[C[C[C[C[C[C[C[C[C[C[C[C[C[C[C[C[C[C[C[C[C[C[C[C[C[C[C[C[C[C[C[C[C[C[C[C[C[C[C[C[C[C[C[C[C[C[C[C[C[C[C[C[C[C[C[C[C[C[C[C[C[C[C[C g++ -g -Wall -std=c++[4P17 -c linear.cc[K[K[K[K[K[K[K[K[K[K[K[K[K[K[K[K[A[C[C[C[C[C[C[C[C[C[C[C[C[C[C[C[C[C[C[C[C[C[C[C[C[C[C[C[C[C[C[C[C[C[C[C[C[C[C[C[C[C[C[C[C[C[C[C[C[C[C[C[C[C[C[C[C[C[C[C[C[C[C[C[C[C[C[C[C[C[C[C[C[C[C[C[C[C[C[C[C[C[C[C[C[C[C[C[C[C[C[C[C[C[C[C[C[C[C[C[C[C[C[C[C[K
[K[A[C[C[C[C[C[C[C[C[C[C[C[C[C[C[C[C[C[C[C[C[C[C[C[C[C[C[C[C[C[C[C[C[C[C[C[C[C[C[C[C[C[C[C[C[C[C[C[C[C[C[C[C[C[C[C[C[C[C[C[C[C[C[C[C[C[C[C[C[C[C[C[C[C[C[C[C[C[C[C[C[C[C[C[C[C[C[C[C[C[C[C[C[C[C[C[C[C[C[C[C[C[C[C[C[K[K[K[K[K[K[K[K[K[K[K[K[K[K[K[K[K[K[K[K g++ -g -Wall -std=c++17 -c linear.cc
alongo5@g7-18:/import/linux/home1/alongo5/i240a/submit/lab1/2-separate-compilation$ g++ fns-compare.o linear.o -o fns-compare
alongo5@g7-18:/import/linux/home1/alongo5/i240a/submit/lab1/2-separate-compilation$ vim quadratic.cc
[?1000h[?2004h[?1049h[22;0;0t[?1h=[?2004h[1;49r[?12h[?12l[22;2t[22;1t[27m[23m[29m[m[H[2J[?25l[49;1H"quadratic.cc" 11L, 183C[2;1H▽[6n[2;1H  [1;1H[>c]10;?]11;?[1;1H[35m#include [m[31m"fns-compare.hh"[m

[32mstatic[m [32mdouble[m
quadratic([32mdouble[m n)
{
  [32menum[m { C = [31m1000[m };
  [38;5;130mreturn[m C*n*n;
}

[32mstatic[m [32mconst[m [32mbool[m isRegistered =
  register_fn(FnInfo([31m"quadratic"[m, quadratic));
[94m~                                                                                                        [13;1H~                                                                                                        [14;1H~                                                                                                        [15;1H~                                                                                                        [16;1H~                                                                                                        [17;1H~                                                                                                        [18;1H~                                                                                                        [19;1H~                                                                                                        [20;1H~                                                                                                        [21;1H~                                                                                                        [22;1H~                                                                                                        [23;1H~                                                                                                        [24;1H~                                                                                                        [25;1H~                                                                                                        [26;1H~                                                                                                        [27;1H~                                                                                                        [28;1H~                                                                                                        [29;1H~                                                                                                        [30;1H~                                                                                                        [31;1H~                                                                                                        [32;1H~                                                                                                        [33;1H~                                                                                                        [34;1H~                                                                                                        [35;1H~                                                                                                        [36;1H~                                                                                                        [37;1H~                                                                                                        [38;1H~                                                                                                        [39;1H~                                                                                                        [40;1H~                                                                                                        [41;1H~                                                                                                        [42;1H~                                                                                                        [43;1H~                                                                                                        [44;1H~                                                                                                        [45;1H~                                                                                                        [46;1H~                                                                                                        [47;1H~                                                                                                        [48;1H~                                                                                                        [m[49;88H1,1[11CAll]2;quadratic.cc (~/projects/i240a/submit/lab1/2-separate-compilation) - VIM]1;quadratic.cc[1;1H[?25hP+q436f\P+q6b75\P+q6b64\P+q6b72\P+q6b6c\P+q2332\P+q2334\P+q2569\P+q2a37\P+q6b31\[?1000l[?1006h[?1002h[?1006l[?1002l[?1006h[?1002h[27m[23m[29m[m[H[2J[?25l[1;1H[38;5;81m#include [m[95m"fns-compare.hh"[m

[38;5;121mstatic[m [38;5;121mdouble[m
quadratic([38;5;121mdouble[m n)
{
  [38;5;121menum[m { C = [95m1000[m };
  [93mreturn[m C*n*n;
}

[38;5;121mstatic[m [38;5;121mconst[m [38;5;121mbool[m isRegistered =
  register_fn(FnInfo([95m"quadratic"[m, quadratic));
[94m~                                                                                                        [13;1H~                                                                                                        [14;1H~                                                                                                        [15;1H~                                                                                                        [16;1H~                                                                                                        [17;1H~                                                                                                        [18;1H~                                                                                                        [19;1H~                                                                                                        [20;1H~                                                                                                        [21;1H~                                                                                                        [22;1H~                                                                                                        [23;1H~                                                                                                        [24;1H~                                                                                                        [25;1H~                                                                                                        [26;1H~                                                                                                        [27;1H~                                                                                                        [28;1H~                                                                                                        [29;1H~                                                                                                        [30;1H~                                                                                                        [31;1H~                                                                                                        [32;1H~                                                                                                        [33;1H~                                                                                                        [34;1H~                                                                                                        [35;1H~                                                                                                        [36;1H~                                                                                                        [37;1H~                                                                                                        [38;1H~                                                                                                        [39;1H~                                                                                                        [40;1H~                                                                                                        [41;1H~                                                                                                        [42;1H~                                                                                                        [43;1H~                                                                                                        [44;1H~                                                                                                        [45;1H~                                                                                                        [46;1H~                                                                                                        [47;1H~                                                                                                        [48;1H~                                                                                                        [m[49;88H1,1[11CAll"quadratic.cc" 11L, 183C[1;1H[?25h[?25l[49;78H^[[1;1H[49;78H  [1;1H[49;78H^[[1;1H[49;78H  [1;1H[?25h[?25l[49;78H:[1;1H[49;1H[K[49;1H:[?2004h[?25hw[?25l[?25hq[?25l[?25h[?25l[?1006l[?1002l[?2004l"quadratic.cc" 11L, 183C written]2;Terminal - ]1;Terminal - [23;2t[23;1t[22;2t[22;1t[23;2t[23;1t
[?2004l[?1l>[?25h[?1049l[23;0;0talongo5@g7-18:/import/linux/home1/alongo5/i240a/submit/lab1/2-separate-compilation$ vim quadratic.ccg++ fns-compare.o linear.o -o fns-compare[A[C[C[C[C[C[C[C[C[C[C[C[C[C[C[C[C[C[C[C[C[C[C[C[C[C[C[C[C[C[C[C[C[C[C[C[C[C[C[C[C[C[C[C[C[C[C[C[C[C[C[C[C[C[C[C[C[C[C[C[C[C[C[C[C g++ -g -Wall -std=c++[4P17 -c linear.cc[K[K[K[K[K[K[K[K[Kquadratic.cc [K
alongo5@g7-18:/import/linux/home1/alongo5/i240a/submit/lab1/2-separate-compilation$  g++ -g -Wall -std=c++17 -c quadratic.cc[A[C[C[C[C[C[C[C[C[C[C[C[C[C[C[C[C[C[C[C[C[C[C[C[C[C[C[C[C[C[C[C[C[C[C[C[C[C[C[C[C[C[C[C[C[C[C[C[C[C[C[C[C[C[C[C[C[C[C[C[C[C[C[C[C[C[5Pvim quadratic.cc
[K[A[C[C[C[C[C[C[C[C[C[C[C[C[C[C[C[C[C[C[C[C[C[C[C[C[C[C[C[C[C[C[C[C[C[C[C[C[C[C[C[C[C[C[C[C[C[C[C[C[C[C[C[C[C[C[C[C[C[C[C[C[C[C[C[C[C[C[C[C[C[C[C[C[C[C[C[C[C[C[C[C[C[C[C[C[C[C[C[C[C[C[C[C[C[C[C[C[C[C[C[Cg++ fns-compare.o linear.o -o fns-compare[C[C[C[1@q[1@u[1P[1P[C[1@ [1@q[1@u[1@a[1@d[1@r[1@a[1@t[1@i[1@c[1@.[1@o
alongo5@g7-18:/import/linux/home1/alongo5/i240a/submit/lab1/2-separate-compilation$ ./fns-compare 
         n    linear quadratic
         1     10000      1000
        10    100000    100000
       100     1e+06     1e+07
      1000     1e+07     1e+09
     10000     1e+08     1e+11
    100000     1e+09     1e+13
alongo5@g7-18:/import/linux/home1/alongo5/i240a/submit/lab1/2-separate-compilation$ cd ./[K./3-makefile/
alongo5@g7-18:/import/linux/home1/alongo5/i240a/submit/lab1/3-makefile$ na[K[Ka[Kmake
make: Nothing to be done for 'all'.
alongo5@g7-18:/import/linux/home1/alongo5/i240a/submit/lab1/3-makefile$ makecd ../3-makefile/[3P./fns-compare cd ../3-makefile/make[K[Kvim h[Kfns-compare.gh[K[Khh 
[?1000h[?2004h[?1049h[22;0;0t[?1h=[?2004h[1;49r[?12h[?12l[22;2t[22;1t[27m[23m[29m[m[H[2J[?25l[49;1H"fns-compare.hh" 20L, 456C[2;1H▽[6n[2;1H  [1;1H[>c]10;?]11;?[1;1H[35m#ifndef FNS_COMPARE_H_
#define FNS_COMPARE_H_[m

[34m/** use long double to minimize overflow */[m
[32mtypedef[m [32mfloat[m Float;

[34m/** type of a complexity function */[m
[32mtypedef[m Float FN(Float);

[34m/** information for a complexity function */[m
[32mstruct[m FnInfo {
  FnInfo([32mconst[m [32mchar[m *descr, FN *fn) : descr(descr), fn(fn) { }
  [32mconst[m [32mchar[m *descr;
  FN *fn;
};

[34m/** function used to register information for a complexity function */[m
[32mbool[m register_fn([32mconst[m FnInfo fnInfo);

[35m#endif[m
[94m~                                                                                                        [22;1H~                                                                                                        [23;1H~                                                                                                        [24;1H~                                                                                                        [25;1H~                                                                                                        [26;1H~                                                                                                        [27;1H~                                                                                                        [28;1H~                                                                                                        [29;1H~                                                                                                        [30;1H~                                                                                                        [31;1H~                                                                                                        [32;1H~                                                                                                        [33;1H~                                                                                                        [34;1H~                                                                                                        [35;1H~                                                                                                        [36;1H~                                                                                                        [37;1H~                                                                                                        [38;1H~                                                                                                        [39;1H~                                                                                                        [40;1H~                                                                                                        [41;1H~                                                                                                        [42;1H~                                                                                                        [43;1H~                                                                                                        [44;1H~                                                                                                        [45;1H~                                                                                                        [46;1H~                                                                                                        [47;1H~                                                                                                        [48;1H~                                                                                                        [m[49;88H5,13[10CAll]2;fns-compare.hh (~/projects/i240a/submit/lab1/3-makefile) - VIM]1;fns-compare.hh[5;13H[?25hP+q436f\P+q6b75\P+q6b64\P+q6b72\P+q6b6c\P+q2332\P+q2334\P+q2569\P+q2a37\P+q6b31\[?1000l[?1006h[?1002h[?1006l[?1002l[?1006h[?1002h[27m[23m[29m[m[H[2J[?25l[1;1H[38;5;81m#ifndef FNS_COMPARE_H_
#define FNS_COMPARE_H_[m

[96m/** use long double to minimize overflow */[m
[38;5;121mtypedef[m [38;5;121mfloat[m Float;

[96m/** type of a complexity function */[m
[38;5;121mtypedef[m Float FN(Float);

[96m/** information for a complexity function */[m
[38;5;121mstruct[m FnInfo {
  FnInfo([38;5;121mconst[m [38;5;121mchar[m *descr, FN *fn) : descr(descr), fn(fn) { }
  [38;5;121mconst[m [38;5;121mchar[m *descr;
  FN *fn;
};

[96m/** function used to register information for a complexity function */[m
[38;5;121mbool[m register_fn([38;5;121mconst[m FnInfo fnInfo);

[38;5;81m#endif[m
[94m~                                                                                                        [22;1H~                                                                                                        [23;1H~                                                                                                        [24;1H~                                                                                                        [25;1H~                                                                                                        [26;1H~                                                                                                        [27;1H~                                                                                                        [28;1H~                                                                                                        [29;1H~                                                                                                        [30;1H~                                                                                                        [31;1H~                                                                                                        [32;1H~                                                                                                        [33;1H~                                                                                                        [34;1H~                                                                                                        [35;1H~                                                                                                        [36;1H~                                                                                                        [37;1H~                                                                                                        [38;1H~                                                                                                        [39;1H~                                                                                                        [40;1H~                                                                                                        [41;1H~                                                                                                        [42;1H~                                                                                                        [43;1H~                                                                                                        [44;1H~                                                                                                        [45;1H~                                                                                                        [46;1H~                                                                                                        [47;1H~                                                                                                        [48;1H~                                                                                                        [m[49;88H5,13[10CAll"fns-compare.hh" 20L, 456C[5;13H[?25h[?25l[49;78H~@k[5;13H[49;78H   [6;1H[49;88H6,0-1[6;1H[?25h[?25l[49;78H~@k[6;1H[49;78H   [5;1H[49;88H5,1  [5;1H[?25h[?25l[49;78H~@k[5;1H[49;78H   [5;2H[49;90H2[5;2H[?25h[?25l[49;78H~@k[5;2H[49;78H   [5;3H[49;90H3[5;3H[?25h[?25l[49;78H~@k[5;3H[49;78H   [5;4H[49;90H4[5;4H[?25h[?25l[49;78H~@k[5;4H[49;78H   [5;5H[49;90H5[5;5H[?25h[?25l[49;78H~@k[5;5H[49;78H   [5;6H[49;90H6[5;6H[?25h[?25l[49;78H~@k[5;6H[49;78H   [5;7H[49;90H7[5;7H[?25h[?25l[49;78H~@k[5;7H[49;78H   [5;8H[49;90H8[5;8H[?25h[?25l[49;78H~@k[5;8H[49;78H   [5;9H[49;90H9[5;9H[?25h[?25l[49;78H~@k[5;9H[49;78H   [5;10H[49;90H10[5;10H[?25h[?25l[49;78H~@k[5;10H[49;78H   [5;11H[49;91H1[5;11H[?25h[?25l[49;78H~@k[5;11H[49;78H   [5;12H[49;91H2[5;12H[?25h[?25l[49;78H~@k[5;12H[49;78H   [5;13H[49;91H3[5;13H[?25h[?25l[49;78H^[[5;13H[49;78H  [5;13H[49;78H^[[5;13H[49;78H  [5;13H[?25h[?25l[49;78H:[5;13H[49;1H[K[49;1H:[?2004h[?25hw[?25l[?25hq[?25l[?25h[?25l[?1006l[?1002l[?2004l"fns-compare.hh" 20L, 456C written]2;Terminal - ]1;Terminal - [23;2t[23;1t[22;2t[22;1t[23;2t[23;1t
[?2004l[?1l>[?25h[?1049l[23;0;0talongo5@g7-18:/import/linux/home1/alongo5/i240a/submit/lab1/3-makefile$ ./fns-compare 
    n constant     log2   linear     n lg    quadr    cubic     expn     fact
    1    1e+07        0    1e+05        0    1e+03    1e+02       20        1
   10    1e+07  3.3e+06    1e+06  3.3e+05    1e+05    1e+05    1e+04  3.6e+06
  100    1e+07  6.6e+06    1e+07  6.6e+06    1e+07    1e+08  1.3e+31 9.3e+157
 1000    1e+07    1e+07    1e+08    1e+08    1e+09    1e+11 1.1e+302      inf
10000    1e+07  1.3e+07    1e+09  1.3e+09    1e+11    1e+14      inf      inf
alongo5@g7-18:/import/linux/home1/alongo5/i240a/submit/lab1/3-makefile$ ./fns-compare [5@vim fns-compare.hh[Cmake[Kcd ../3-makefile/make[K
make: Nothing to be done for 'all'.
alongo5@g7-18:/import/linux/home1/alongo5/i240a/submit/lab1/3-makefile$ make./fns-compare 
    n constant     log2   linear     n lg    quadr    cubic     expn     fact
    1    1e+07        0    1e+05        0    1e+03    1e+02       20        1
   10    1e+07  3.3e+06    1e+06  3.3e+05    1e+05    1e+05    1e+04  3.6e+06
  100    1e+07  6.6e+06    1e+07  6.6e+06    1e+07    1e+08  1.3e+31 9.3e+157
 1000    1e+07    1e+07    1e+08    1e+08    1e+09    1e+11 1.1e+302      inf
10000    1e+07  1.3e+07    1e+09  1.3e+09    1e+11    1e+14      inf      inf
alongo5@g7-18:/import/linux/home1/alongo5/i240a/submit/lab1/3-makefile$ cd ../4-dependencies/
alongo5@g7-18:/import/linux/home1/alongo5/i240a/submit/lab1/4-dependencies$ gedit Makefile

(gedit:186766): Gtk-[1;33mWARNING[0m **: [34m14:09:06.160[0m: Calling org.xfce.Session.Manager.Inhibit failed: GDBus.Error:org.freedesktop.DBus.Error.UnknownMethod: Method "Inhibit" with signature "susu" on interface "org.xfce.Session.Manager" doesn't exist

alongo5@g7-18:/import/linux/home1/alongo5/i240a/submit/lab1/4-dependencies$ gedit Makefilecd ../4-dependencies/[7Pgedit Makefile[Kmake
make: Nothing to be done for 'all'.
alongo5@g7-18:/import/linux/home1/alongo5/i240a/submit/lab1/4-dependencies$ ./fns-compare 
    n constant     log2   linear     n lg    quadr    cubic     expn     fact
    1    1e+07        0    1e+05        0    1e+03    1e+02       20        1
   10    1e+07  3.3e+06    1e+06  3.3e+05    1e+05    1e+05    1e+04  3.6e+06
  100    1e+07  6.6e+06    1e+07  6.6e+06    1e+07    1e+08  1.3e+31 9.3e+157
 1000    1e+07    1e+07    1e+08    1e+08    1e+09    1e+11 1.1e+302      inf
10000    1e+07  1.3e+07    1e+09  1.3e+09    1e+11    1e+14      inf      inf
alongo5@g7-18:/import/linux/home1/alongo5/i240a/submit/lab1/4-dependencies$ cd 4[K../5-auto-dependencies/
alongo5@g7-18:/import/linux/home1/alongo5/i240a/submit/lab1/5-auto-dependencies$ g++ fns-compare.o linear.o -o fns-compare[K[K[K[K[K[K[K[K[K[K[K[K[K[K[K[K[K[A[C[C[C[C[C[C[C[C[C[C[C[C[C[C[C[C[C[C[C[C[C[C[C[C[C[C[C[C[C[C[C[C[C[C[C[C[C[C[C[C[C[C[C[C[C[C[C[C[C[C[C[C[C[C[C[C[C[C[C[C[C[C[C[C[C[C[C[C[C[C[C[C[C[C[C[C[C[C[C[C[C[C[C[C[C[C[C[C[C[C[C[C[C[C[C[C[C[C[C[C[C[C[C[C[K
[K[A[C[C[C[C[C[C[C[C[C[C[C[C[C[C[C[C[C[C[C[C[C[C[C[C[C[C[C[C[C[C[C[C[C[C[C[C[C[C[C[C[C[C[C[C[C[C[C[C[C[C[C[C[C[C[C[C[C[C[C[C[C[C[C[C[C[C[C[C[C[C[C[C[C[C[C[C[C[C[C[C[C[C[C[C[C[C[C[C[C[C[C[C[C[C[C[C[C[C[C[C[C[C[C[C[K[K[K[K[K[K[K[K[K[K[K[K[K[K[K[K[K[K[K[K[K[K[Kmake
make: Nothing to be done for 'all'.
alongo5@g7-18:/import/linux/home1/alongo5/i240a/submit/lab1/5-auto-dependencies$ ls -a
.	     cubic.cc	     exponential.o  fns-compare.cc  lg.cc      Makefile      quadratic.o
..	     cubic.o	     fact.cc	    fns-compare.hh  lg.o       nlg.cc
constant.cc  .deps	     fact.o	    fns-compare.o   linear.cc  nlg.o
constant.o   exponential.cc  fns-compare    .gitignore	    linear.o   quadratic.cc
alongo5@g7-18:/import/linux/home1/alongo5/i240a/submit/lab1/5-auto-dependencies$ cd .deps/
alongo5@g7-18:/import/linux/home1/alongo5/i240a/submit/lab1/5-auto-dependencies/.deps$ ls
constant.d  cubic.d  exponential.d  fact.d  fns-compare.d  lg.d  linear.d  nlg.d  quadratic.d
alongo5@g7-18:/import/linux/home1/alongo5/i240a/submit/lab1/5-auto-dependencies/.deps$ cd ..
alongo5@g7-18:/import/linux/home1/alongo5/i240a/submit/lab1/5-auto-dependencies$ gedit Makefile 

(gedit:186916): Gtk-[1;33mWARNING[0m **: [34m14:10:52.541[0m: Calling org.xfce.Session.Manager.Inhibit failed: GDBus.Error:org.freedesktop.DBus.Error.UnknownMethod: Method "Inhibit" with signature "susu" on interface "org.xfce.Session.Manager" doesn't exist

alongo5@g7-18:/import/linux/home1/alongo5/i240a/submit/lab1/5-auto-dependencies$ mkdir dist
alongo5@g7-18:/import/linux/home1/alongo5/i240a/submit/lab1/5-auto-dependencies$ ls
constant.cc  dist	     fact.o	     fns-compare.o  linear.o  quadratic.cc
constant.o   exponential.cc  fns-compare     lg.cc	    Makefile  quadratic.o
cubic.cc     exponential.o   fns-compare.cc  lg.o	    nlg.cc
cubic.o      fact.cc	     fns-compare.hh  linear.cc	    nlg.o
alongo5@g7-18:/import/linux/home1/alongo5/i240a/submit/lab1/5-auto-dependencies$ lsmkdir distgedit Makefile 

(gedit:187766): Gtk-[1;33mWARNING[0m **: [34m14:17:42.354[0m: Calling org.xfce.Session.Manager.Inhibit failed: GDBus.Error:org.freedesktop.DBus.Error.UnknownMethod: Method "Inhibit" with signature "susu" on interface "org.xfce.Session.Manager" doesn't exist

alongo5@g7-18:/import/linux/home1/alongo5/i240a/submit/lab1/5-auto-dependencies$ gedit Makefile ls[Kmkdir distgedit Makefile [10Pcd ..[3Plscd .deps/[4Pls -a[1Pmakecd ../5-auto-dependencies/[A[C[C[C[C[C[C[C[C[C[C[C[C[C[C[C[C[C[C[C[C[C[C[C[C[C[C[C[C[C[C[C[C[C[C[C[C[C[C[C[C[C[C[C[C[C[C[C[C[C[C[C[C[C[C[C[C[C[C[C[C[C[C[C[C[C[C[C[C[C[C[C[C[C[C[C[C[C[C[Cmake[K
[K[A[C[C[C[C[C[C[C[C[C[C[C[C[C[C[C[C[C[C[C[C[C[C[C[C[C[C[C[C[C[C[C[C[C[C[C[C[C[C[C[C[C[C[C[C[C[C[C[C[C[C[C[C[C[C[C[C[C[C[C[C[C[C[C[C[C[C[C[C[C[C[C[C[C[C[C[C[C[C[C[C[C[C[C[C[Cls -acd .deps/ls[Kcd ..gedit Makefile [5Pmkdir distls[Kgedit Makefile [Kmake dist
Makefile:10: *** missing separator.  Stop.
alongo5@g7-18:/import/linux/home1/alongo5/i240a/submit/lab1/5-auto-dependencies$ make distgedit Makefile ls[Kgedit Makefile ls[Kgedit Makefile 

(gedit:187871): Gtk-[1;33mWARNING[0m **: [34m14:18:34.763[0m: Calling org.xfce.Session.Manager.Inhibit failed: GDBus.Error:org.freedesktop.DBus.Error.UnknownMethod: Method "Inhibit" with signature "susu" on interface "org.xfce.Session.Manager" doesn't exist

^[[Aalongo5@g7-18:/import/linux/home1/alongo5/i240a/submit/lab1/5-auto-dependencies$ gedit Makefile [6Pmake dist
Makefile:10: *** missing separator.  Stop.
alongo5@g7-18:/import/linux/home1/alongo5/i240a/submit/lab1/5-auto-dependencies$ make distgedit Makefile 

(gedit:187922): Gtk-[1;33mWARNING[0m **: [34m14:19:00.325[0m: Calling org.xfce.Session.Manager.Inhibit failed: GDBus.Error:org.freedesktop.DBus.Error.UnknownMethod: Method "Inhibit" with signature "susu" on interface "org.xfce.Session.Manager" doesn't exist

alongo5@g7-18:/import/linux/home1/alongo5/i240a/submit/lab1/5-auto-dependencies$ gedit Makefile [6Pmake dist
make: *** No rule to make target 'tar', needed by 'dist'.  Stop.
alongo5@g7-18:/import/linux/home1/alongo5/i240a/submit/lab1/5-auto-dependencies$ make distgedit Makefile [6Pmake distgedit Makefile [6Pmake distgedit Makefile [6Pmake distgedit Makefile [6Pmake distgedit Makefile [6Pmake distgedit Makefile 

(gedit:188039): Gtk-[1;33mWARNING[0m **: [34m14:20:29.916[0m: Calling org.xfce.Session.Manager.Inhibit failed: GDBus.Error:org.freedesktop.DBus.Error.UnknownMethod: Method "Inhibit" with signature "susu" on interface "org.xfce.Session.Manager" doesn't exist

alongo5@g7-18:/import/linux/home1/alongo5/i240a/submit/lab1/5-auto-dependencies$ gedit Makefile [6Pmake dist
make: *** No rule to make target 'tar', needed by 'dist'.  Stop.
alongo5@g7-18:/import/linux/home1/alongo5/i240a/submit/lab1/5-auto-dependencies$ make distgedit Makefile 
alongo5@g7-18:/import/linux/home1/alongo5/i240a/submit/lab1/5-auto-dependencies$ make dist
make: *** No rule to make target 'tar', needed by 'dist'.  Stop.
alongo5@g7-18:/import/linux/home1/alongo5/i240a/submit/lab1/5-auto-dependencies$ ls
constant.cc  dist	     fact.o	     fns-compare.o  linear.o  quadratic.cc
constant.o   exponential.cc  fns-compare     lg.cc	    Makefile  quadratic.o
cubic.cc     exponential.o   fns-compare.cc  lg.o	    nlg.cc
cubic.o      fact.cc	     fns-compare.hh  linear.cc	    nlg.o
alongo5@g7-18:/import/linux/home1/alongo5/i240a/submit/lab1/5-auto-dependencies$ ls -a
.	     cubic.cc  exponential.cc  fns-compare     .gitignore  linear.o  quadratic.cc
..	     cubic.o   exponential.o   fns-compare.cc  lg.cc	   Makefile  quadratic.o
constant.cc  .deps     fact.cc	       fns-compare.hh  lg.o	   nlg.cc
constant.o   dist      fact.o	       fns-compare.o   linear.cc   nlg.o
alongo5@g7-18:/import/linux/home1/alongo5/i240a/submit/lab1/5-auto-dependencies$ gedut[K[K[K[K[Kls -a[Kmake distgedit Makefile 

(gedit:188459): Gtk-[1;33mWARNING[0m **: [34m14:23:44.158[0m: Calling org.xfce.Session.Manager.Inhibit failed: GDBus.Error:org.freedesktop.DBus.Error.UnknownMethod: Method "Inhibit" with signature "susu" on interface "org.xfce.Session.Manager" doesn't exist

alongo5@g7-18:/import/linux/home1/alongo5/i240a/submit/lab1/5-auto-dependencies$ gedit Makefile [10Pls -a[Kmake dist
make: 'dist' is up to date.
alongo5@g7-18:/import/linux/home1/alongo5/i240a/submit/lab1/5-auto-dependencies$ ls
constant.cc  dist	     fact.o	     fns-compare.o  linear.o  quadratic.cc
constant.o   exponential.cc  fns-compare     lg.cc	    Makefile  quadratic.o
cubic.cc     exponential.o   fns-compare.cc  lg.o	    nlg.cc
cubic.o      fact.cc	     fns-compare.hh  linear.cc	    nlg.o
alongo5@g7-18:/import/linux/home1/alongo5/i240a/submit/lab1/5-auto-dependencies$ cd dist/
alongo5@g7-18:/import/linux/home1/alongo5/i240a/submit/lab1/5-auto-dependencies/dist$ ls
alongo5@g7-18:/import/linux/home1/alongo5/i240a/submit/lab1/5-auto-dependencies/dist$ ls -a
.  ..
alongo5@g7-18:/import/linux/home1/alongo5/i240a/submit/lab1/5-auto-dependencies/dist$ cd .
alongo5@g7-18:/import/linux/home1/alongo5/i240a/submit/lab1/5-auto-dependencies/dist$ cd ..
alongo5@g7-18:/import/linux/home1/alongo5/i240a/submit/lab1/5-auto-dependencies$ cd ..[Kls -a[Kcd dist/ls[Kmake distgedit Makefile 

(gedit:188678): Gtk-[1;33mWARNING[0m **: [34m14:25:39.141[0m: Calling org.xfce.Session.Manager.Inhibit failed: GDBus.Error:org.freedesktop.DBus.Error.UnknownMethod: Method "Inhibit" with signature "susu" on interface "org.xfce.Session.Manager" doesn't exist

alongo5@g7-18:/import/linux/home1/alongo5/i240a/submit/lab1/5-auto-dependencies$ gedit Makefile [10Pcd ..[Kls -a[Kcd dist/ls[Kmake dist
make: 'dist' is up to date.
alongo5@g7-18:/import/linux/home1/alongo5/i240a/submit/lab1/5-auto-dependencies$ make distgedit Makefile [10Pcd ..gedit Makefile [6Pmake distgedit Makefile 
alongo5@g7-18:/import/linux/home1/alongo5/i240a/submit/lab1/5-auto-dependencies$ ls  cd di[K[K[K[K[K[K[K[K[Kcd dist/
alongo5@g7-18:/import/linux/home1/alongo5/i240a/submit/lab1/5-auto-dependencies/dist$ ls
alongo5@g7-18:/import/linux/home1/alongo5/i240a/submit/lab1/5-auto-dependencies/dist$ -a
bash: -a: command not found
alongo5@g7-18:/import/linux/home1/alongo5/i240a/submit/lab1/5-auto-dependencies/dist$ ls 0a[K[K-a
.  ..
alongo5@g7-18:/import/linux/home1/alongo5/i240a/submit/lab1/5-auto-dependencies/dist$ cd ..
alongo5@g7-18:/import/linux/home1/alongo5/i240a/submit/lab1/5-auto-dependencies$ r,m -rf [K[K[K[K[K[K[Km -rf s[Kdist/
alongo5@g7-18:/import/linux/home1/alongo5/i240a/submit/lab1/5-auto-dependencies$ make dist
tar -cf fns-compare.tar *.cc *.hh Makefile
alongo5@g7-18:/import/linux/home1/alongo5/i240a/submit/lab1/5-auto-dependencies$ cd d[Kdi[K[K[K[K[Kls
constant.cc  exponential.cc  fns-compare     fns-compare.tar  linear.o	quadratic.cc
constant.o   exponential.o   fns-compare.cc  lg.cc	      Makefile	quadratic.o
cubic.cc     fact.cc	     fns-compare.hh  lg.o	      nlg.cc
cubic.o      fact.o	     fns-compare.o   linear.cc	      nlg.o
alongo5@g7-18:/import/linux/home1/alongo5/i240a/submit/lab1/5-auto-dependencies$ ml[Kkdir -p ~/tmp/fns-compa re
alongo5@g7-18:/import/linux/home1/alongo5/i240a/submit/lab1/5-auto-dependencies$ cd ~/tmp/fns-compare/
alongo5@g7-18:~/tmp/fns-compare$ tar -xfv ~/it[K240a/submit/lab1/5-auto-dependencies/fns-compare.tar [K
tar: v: Cannot open: No such file or directory
tar: Error is not recoverable: exiting now
alongo5@g7-18:~/tmp/fns-compare$ ls
alongo5@g7-18:~/tmp/fns-compare$ lstar -xfv ~/i240a/submit/lab1/5-auto-dependencies/fns-compare.tare5-auto-dependencies/fns-compare.tarx5-auto-dependencies/fns-compare.tare5-auto-dependencies/fns-compare.tarr5-auto-dependencies/fns-compare.tarc5-auto-dependencies/fns-compare.tari5-auto-dependencies/fns-compare.tars5-auto-dependencies/fns-compare.tare5-auto-dependencies/fns-compare.tar [A[C[C[C[C[C[C[C[C[C[C[C[C[C[C[C[C[C[C[C[C[C[C[C[C[C[C[C[C[C[C[C[C[C[C[C[C[C[C[C[C[C[C[C[C[C[C[C[C[C[C[C[C[C[C[C[C[C[C[C[C[C[C[C[C[C[C[C[C[Cs5-auto-dependencies/fns-compare.tar[A[C[C[C[C[C[C[C[C[C[C[C[C[C[C[C[C[C[C[C[C[C[C[C[C[C[C[C[C[C[C[C[C[C[C[C[C[C[C[C[C[C[C[C[C[C[C[C[C[C[C[C[C[C[C[C[C[C[C[C[C[C[C[C[C[C[C[C[C[C[C/5-auto-dependencies/fns-compare.tar[A[C[C[C[C[C[C[C[C[C[C[C[C[C[C[C[C[C[C[C[C[C[C[C[C[C[C[C[C[C[C[C[C[C[C[C[C[C[C[C[C[C[C[C[C[C[C[C[C[C[C[C[C[C[C[C[C[C[C[C[C[C[C[C[C[C[C[C[C[C[C

tar: v: Cannot open: No such file or directory
tar: Error is not recoverable: exiting now
alongo5@g7-18:~/tmp/fns-compare$ tar -xfv ~/i240a/submit/lab1/exercises/5-auto-dependencies/fns-compare.tar .
tar: v: Cannot open: No such file or directory
tar: Error is not recoverable: exiting now
alongo5@g7-18:~/tmp/fns-compare$ tar -xfv ~/i240a/submit/lab1/exercises/5-auto-dependencies/fns-compare.tar .[K .[K[A[C[C[C[C[C[C[C[C[C[C[C[C[C[C[C[C[C[C[C[C[C[C[C[C[C[C[C[C[C[C[Cls[K
[K[A[C[C[C[C[C[C[C[C[C[C[C[C[C[C[C[C[C[C[C[C[C[C[C[C[C[C[C[C[C[C[C[C[C[C[Ctar -xfv ~/i240a/submit/lab1/5-auto-dependencies/fns-compare.tar .
tar: v: Cannot open: No such file or directory
tar: Error is not recoverable: exiting now
alongo5@g7-18:~/tmp/fns-compare$ tar -xfv ~/i240a/submit/lab1/5-auto-dependencies/fns-compare.tar .[C[1P[C[1@f
tar: .: Not found in archive
tar: Exiting with failure status due to previous errors
alongo5@g7-18:~/tmp/fns-compare$ ta[K[Kls
alongo5@g7-18:~/tmp/fns-compare$ tar -xvf ~/i240a/submit/lab1/5-auto-dependencies/fns-compare.tar
constant.cc
cubic.cc
exponential.cc
fact.cc
fns-compare.cc
lg.cc
linear.cc
nlg.cc
quadratic.cc
fns-compare.hh
Makefile
alongo5@g7-18:~/tmp/fns-compare$ make
g++ -MT linear.o -MMD -MP -MF .deps/linear.d -g -Wall -std=c++17 -c linear.cc
g++ -MT nlg.o -MMD -MP -MF .deps/nlg.d -g -Wall -std=c++17 -c nlg.cc
g++ -MT fact.o -MMD -MP -MF .deps/fact.d -g -Wall -std=c++17 -c fact.cc
g++ -MT lg.o -MMD -MP -MF .deps/lg.d -g -Wall -std=c++17 -c lg.cc
g++ -MT cubic.o -MMD -MP -MF .deps/cubic.d -g -Wall -std=c++17 -c cubic.cc
g++ -MT exponential.o -MMD -MP -MF .deps/exponential.d -g -Wall -std=c++17 -c exponential.cc
g++ -MT fns-compare.o -MMD -MP -MF .deps/fns-compare.d -g -Wall -std=c++17 -c fns-compare.cc
g++ -MT constant.o -MMD -MP -MF .deps/constant.d -g -Wall -std=c++17 -c constant.cc
g++ -MT quadratic.o -MMD -MP -MF .deps/quadratic.d -g -Wall -std=c++17 -c quadratic.cc
g++ linear.o nlg.o fact.o lg.o cubic.o exponential.o fns-compare.o constant.o quadratic.o -o fns-compare
alongo5@g7-18:~/tmp/fns-compare$ ls
constant.cc  cubic.o	     fact.cc	  fns-compare.cc  lg.cc      linear.o  nlg.o
constant.o   exponential.cc  fact.o	  fns-compare.hh  lg.o	     Makefile  quadratic.cc
cubic.cc     exponential.o   fns-compare  fns-compare.o   linear.cc  nlg.cc    quadratic.o
alongo5@g7-18:~/tmp/fns-compare$ exit

Script done on 2020-01-30 14:35:24-05:00 [COMMAND_EXIT_CODE="0"]
