Script started on 2020-01-23 13:17:23-05:00 [TERM="xterm-256color" TTY="/dev/pts/0" COLUMNS="80" LINES="24"]
alongo5@g7-08:~/tmp/lab0$ ls ~/.ssh
ls: cannot access '/home/alongo5/.ssh': No such file or directory
alongo5@g7-08:~/tmp/lab0$ ssh-keygen 
Generating public/private rsa key pair.
Enter file in which to save the key (/home/alongo5/.ssh/id_rsa): 
Created directory '/home/alongo5/.ssh'.
Enter passphrase (empty for no passphrase): 
Enter same passphrase again: 
Your identification has been saved in /home/alongo5/.ssh/id_rsa.
Your public key has been saved in /home/alongo5/.ssh/id_rsa.pub.
The key fingerprint is:
SHA256:zrb91lW37MQX8tSlsiLljcs0ypH0A2NMO0jBNJsqGG0 alongo5@g7-08
The key's randomart image is:
+---[RSA 2048]----+
|     o+.         |
| .    o+.       .|
|. E  .o+ .     .o|
| +   .. O . ...o+|
|. . .  oSO o o* =|
|   .   o+ O o  *o|
|       .+* = .o..|
|       .ooo . .. |
|        . .o.    |
+----[SHA256]-----+
alongo5@g7-08:~/tmp/lab0$ ls
lab0.LOG
alongo5@g7-08:~/tmp/lab0$ ls ~.s[K[K/.ssh/
id_rsa	id_rsa.pub
alongo5@g7-08:~/tmp/lab0$ ssh-copy-id -i alongo5@remote
/usr/bin/ssh-copy-id: INFO: Source of key(s) to be installed: "/home/alongo5/.ssh/id_rsa.pub"
The authenticity of host 'remote (128.226.114.207)' can't be established.
ECDSA key fingerprint is SHA256:UEIh1TASIC96TC1hhxVbkVS0DrddNKHk7Q2nzgDCt+Y.
Are you sure you want to continue connecting (yes/no)? yes
/usr/bin/ssh-copy-id: INFO: attempting to log in with the new key(s), to filter out any that are already installed
/usr/bin/ssh-copy-id: INFO: 1 key(s) remain to be installed -- if you are prompted now it is to install the new keys
alongo5@remote's password: 

Number of key(s) added: 1

Now try logging into the machine, with:   "ssh 'alongo5@remote'"
and check to make sure that only the key(s) you wanted were added.

alongo5@g7-08:~/tmp/lab0$ vim ~/.profile
[?1000h[?2004h[?1049h[22;0;0t[?1h=[?2004h[1;24r[?12h[?12l[22;2t[22;1t[27m[23m[29m[m[H[2J[?25l[24;1H"~/.profile" [New File][2;1H▽[6n[2;1H  [1;1H[>c]10;?]11;?[2;1H[94m~                                                                               [3;1H~                                                                               [4;1H~                                                                               [5;1H~                                                                               [6;1H~                                                                               [7;1H~                                                                               [8;1H~                                                                               [9;1H~                                                                               [10;1H~                                                                               [11;1H~                                                                               [12;1H~                                                                               [13;1H~                                                                               [14;1H~                                                                               [15;1H~                                                                               [16;1H~                                                                               [17;1H~                                                                               [18;1H~                                                                               [19;1H~                                                                               [20;1H~                                                                               [21;1H~                                                                               [22;1H~                                                                               [23;1H~                                                                               [m[24;63H0,0-1[9CAll]2;.profile (~) - VIM]1;.profile[1;1H[?25hP+q436f\P+q6b75\P+q6b64\P+q6b72\P+q6b6c\P+q2332\P+q2334\P+q2569\P+q2a37\P+q6b31\[?1000l[?1006h[?1002h[?1006l[?1002l[?1006h[?1002h[27m[23m[29m[m[H[2J[?25l[2;1H[94m~                                                                               [3;1H~                                                                               [4;1H~                                                                               [5;1H~                                                                               [6;1H~                                                                               [7;1H~                                                                               [8;1H~                                                                               [9;1H~                                                                               [10;1H~                                                                               [11;1H~                                                                               [12;1H~                                                                               [13;1H~                                                                               [14;1H~                                                                               [15;1H~                                                                               [16;1H~                                                                               [17;1H~                                                                               [18;1H~                                                                               [19;1H~                                                                               [20;1H~                                                                               [21;1H~                                                                               [22;1H~                                                                               [23;1H~                                                                               [m[24;63H0,0-1[9CAll"~/.profile" [New File][1;1H[?25h[?25l[24;53H^V[1;1H[24;53H1x1[1;1H[24;1H[1m-- VISUAL BLOCK --[m[24;19H[K[24;53H1x1[1;1H[24;63H0,0-1[9CAll[1;1H[?25h[?25l[24;53Hi  [1;1H[?25h[?25l[24;54H^[[1;1H[24;54H  [1;1H[24;54H^[[1;1H[24;53H1x1[1;1H[?25h[?25l[24;53Hi  [1;1H[?25h[?25l[24;54Hi[1;1H[24;53H1x1[1;1H[?25h[?25l[24;53H   [1;1H[24;1H[K[24;63H0,0-1[9CAll[1;1H[?25h[?25l[24;53Hi[1;1H[24;53H [1;1H[24;1H[1m-- INSERT --[m[24;63H[K[24;63H0,1[11CAll[1;1H[?25h[38;5;81m^[?25l[m[24;53H^V[1;1H[?25h[?25l[24;55H^?[1;1H [24;53H    [1;1H[38;5;81m^?[m[24;63H1,2-3]2;.profile + (~) - VIM]1;.profile[1;3H[?25h[?25l[1;1H[K[24;65H1  [1;1H[?25h[?25li[24;65H2[1;2H[?25h[?25l[1;1H[K[24;65H1[1;1H[?25h[?25l[24;4H[1m(insert)- VISUAL --[m[24;63H[K[24;53H1[1;1H[24;63H1,0-1[9CAll[1;1H[?25h[?25l[?25h[?25l[?25h[?25l[?25h[?25l[24;53H [1;1H[24;4H[1mINSERTt --[m[24;13H[K[24;63H1,1[11CAll[1;1H[?25h[?25lu[24;65H2[1;2H[?25h[?25lm[24;65H3[1;3H[?25h[?25lr[24;65H4[1;4H[?25h[?25li[24;65H5[1;5H[?25h[?25lg[24;65H6[1;6H[?25h[?25la[24;65H7[1;7H[?25h[?25lr[24;65H8[1;8H[?25h[?25l/[24;65H9[1;9H[?25h[?25lc[24;65H10[1;10H[?25h[?25ls[24;66H1[1;11H[?25h[?25l2[24;66H2[1;12H[?25h[?25l4[24;66H3[1;13H[?25h[?25l0[24;66H4[1;14H[?25h[?25l/[24;66H5[1;15H[?25h[?25lb[24;66H6[1;16H[?25h[?25li[24;66H7[1;17H[?25h[?25ln[24;66H8[1;18H[?25h[?25l/[24;66H9[1;19H[?25h[?25ls[24;65H20[1;20H[?25h[?25lt[24;66H1[1;21H[?25h[?25lu[24;66H2[1;22H[?25h[?25ld[24;66H3[1;23H[?25h[?25le[24;66H4[1;24H[?25h[?25ln[24;66H5[1;25H[?25h[?25lt[24;66H6[1;26H[?25h[?25l.[24;66H7[1;27H[?25h[?25lp[24;66H8[1;28H[?25h[?25lr[24;66H9[1;29H[?25h[?25lo[24;65H30[1;30H[?25h[?25lg[24;66H1[1;31H[?25h[?25li[24;66H2[1;32H[?25h[?25ll[24;66H3[1;33H[?25h[?25le[24;66H4[1;34H[?25h[?25l[1;33H[K[24;66H3[1;33H[?25h[?25l[1;32H[K[24;66H2[1;32H[?25h[?25l[1;31H[K[24;66H1[1;31H[?25h[?25l[1;30H[K[24;66H0[1;30H[?25h[?25lf[24;66H1[1;31H[?25h[?25li[24;66H2[1;32H[?25h[?25ll[24;66H3[1;33H[?25h[?25le[24;66H4[1;34H[?25h[24;1H[K[1;33H[?25l[24;53H^[[1;33H[24;53H  [1;34H[24;63H1,33[10CAll[1;33H[?25h[?25l[24;53H:[1;33H[24;53H[K[24;1H:[?2004h[?25hw[?25l[?25hq[?25l[?25h[?25l[?1006l[?1002l[?2004l"~/.profile" [New] 1L, 34C written]2;Terminal - ]1;Terminal - [23;2t[23;1t[22;2t[22;1t[23;2t[23;1t
[?2004l[?1l>[?25h[?1049l[23;0;0talongo5@g7-08:~/tmp/lab0$ vim vim ~/.bash_history [K[K[K[K[K[K[K[K[Krc
2 files to edit
[?1000h[?2004h[?1049h[22;0;0t[?1h=[?2004h[1;24r[?12h[?12l[22;2t[22;1t[27m[23m[29m[m[H[2J[?25l[24;1H"vim" [New File][2;1H▽[6n[2;1H  [1;1H[>c]10;?]11;?[2;1H[94m~                                                                               [3;1H~                                                                               [4;1H~                                                                               [5;1H~                                                                               [6;1H~                                                                               [7;1H~                                                                               [8;1H~                                                                               [9;1H~                                                                               [10;1H~                                                                               [11;1H~                                                                               [12;1H~                                                                               [13;1H~                                                                               [14;1H~                                                                               [15;1H~                                                                               [16;1H~                                                                               [17;1H~                                                                               [18;1H~                                                                               [19;1H~                                                                               [20;1H~                                                                               [21;1H~                                                                               [22;1H~                                                                               [23;1H~                                                                               [m[24;63H0,0-1[9CAll]2;vim (~/tmp/lab0) (1 of 2) - VIM]1;vim[1;1H[?25hP+q436f\P+q6b75\P+q6b64\P+q6b72\P+q6b6c\P+q2332\P+q2334\P+q2569\P+q2a37\P+q6b31\[?1000l[?1006h[?1002h[?1006l[?1002l[?1006h[?1002h[27m[23m[29m[m[H[2J[?25l[2;1H[94m~                                                                               [3;1H~                                                                               [4;1H~                                                                               [5;1H~                                                                               [6;1H~                                                                               [7;1H~                                                                               [8;1H~                                                                               [9;1H~                                                                               [10;1H~                                                                               [11;1H~                                                                               [12;1H~                                                                               [13;1H~                                                                               [14;1H~                                                                               [15;1H~                                                                               [16;1H~                                                                               [17;1H~                                                                               [18;1H~                                                                               [19;1H~                                                                               [20;1H~                                                                               [21;1H~                                                                               [22;1H~                                                                               [23;1H~                                                                               [m[24;63H0,0-1[9CAll"vim" [New File][1;1H[?25h[?25l[24;53Hi[1;1H[24;53H [1;1H[24;1H[1m-- INSERT --[m[24;13H[K[24;63H0,1[11CAll[1;1H[?25h[?25lu[24;63H1,2]2;vim + (~/tmp/lab0) (1 of 2) - VIM]1;vim[1;2H[?25h[?25lm[24;65H3[1;3H[?25h[?25lr[24;65H4[1;4H[?25h[?25li[24;65H5[1;5H[?25h[?25lg[24;65H6[1;6H[?25h[?25la[24;65H7[1;7H[?25h[?25lr[24;65H8[1;8H[?25h[?25l/[24;65H9[1;9H[?25h[?25lc[24;65H10[1;10H[?25h[?25ls[24;66H1[1;11H[?25h[?25l2[24;66H2[1;12H[?25h[?25l4[24;66H3[1;13H[?25h[?25l0[24;66H4[1;14H[?25h[?25l[24;66H3[1;13H[?25h[?25l[24;66H2[1;12H[?25h[?25l[24;66H1[1;11H[?25h[?25l[24;66H0[1;10H[?25h[?25l[24;65H9 [1;9H[?25h[?25l[24;65H8[1;8H[?25h[?25l[24;65H7[1;7H[?25h[?25l[24;65H6[1;6H[?25h[?25l[24;65H5[1;5H[?25h[?25l[24;65H4[1;4H[?25h[?25l[24;65H3[1;3H[?25h[?25l[24;65H2[1;2H[?25h[?25l[24;65H1[1;1H[?25h[?25l[24;66H4[1;14H[?25h[?25l[1;13H[K[24;66H3[1;13H[?25h[?25l[1;12H[K[24;66H2[1;12H[?25h[?25l[1;11H[K[24;66H1[1;11H[?25h[?25l[1;10H[K[24;66H0[1;10H[?25h[?25l[1;9H[K[24;65H9 [1;9H[?25h[?25l[1;8H[K[24;65H8[1;8H[?25h[?25l[1;7H[K[24;65H7[1;7H[?25h[?25l[1;6H[K[24;65H6[1;6H[?25h[?25l[1;5H[K[24;65H5[1;5H[?25h[?25l[1;4H[K[24;65H4[1;4H[?25h[?25l[1;3H[K[24;65H3[1;3H[?25h[?25l[1;2H[K[24;65H2[1;2H[?25h[?25l[1;1H[K[24;65H1[1;1H[?25h[?25li[24;65H2[1;2H[?25h[?25l[1;1H[K[24;65H1[1;1H[?25h[?25l~umrigar/cs240/bin/student.profile[24;65H35[1;35H[?25h[?25l[24;66H4[1;34H[?25h[?25l[24;66H3[1;33H[?25h[?25l[24;66H2[1;32H[?25h[?25l[24;66H1[1;31H[?25h[?25l[24;66H0[1;30H[?25h[?25l[24;65H29[1;29H[?25h[?25l[24;66H8[1;28H[?25h[?25l[24;66H7[1;27H[?25h[?25l[24;66H6[1;26H[?25h[?25l[24;66H5[1;25H[?25h[?25l[24;66H4[1;24H[?25h[?25l[24;66H3[1;23H[?25h[?25l[24;66H2[1;22H[?25h[?25l[24;66H1[1;21H[?25h[?25l[24;66H0[1;20H[?25h[?25l[24;65H19[1;19H[?25h[?25l[24;66H8[1;18H[?25h[?25l[24;66H7[1;17H[?25h[?25l[24;66H6[1;16H[?25h[?25l[24;66H5[1;15H[?25h[?25l[24;66H4[1;14H[?25h[?25l[24;66H3[1;13H[?25h[?25l[24;66H2[1;12H[?25h[?25l[24;66H1[1;11H[?25h[?25l[24;66H0[1;10H[?25h[?25l[24;65H9 [1;9H[?25h[?25l[24;65H8[1;8H[?25h[?25l[24;65H7[1;7H[?25h[?25l[24;65H6[1;6H[?25h[?25l[24;65H5[1;5H[?25h[?25l[24;65H4[1;4H[?25h[?25l[24;65H3[1;3H[?25h[?25l[24;65H2[1;2H[?25h[?25l[24;65H1[1;1H[?25h[?25l.~umrigar/cs240/bin/student.profile[24;65H2[1;2H[?25h[?25l ~umrigar/cs240/bin/student.profile[24;65H3[1;3H[?25h[24;1H[K[1;2H[?25l[24;53H^[[1;2H[24;53H  [1;3H[24;63H1,2[11CAll[1;2H[?25h[?25l[24;53H:[1;2H[24;53H[K[24;1H:[?2004h[?25hw[?25l[?25hq[?25l[?25h[?25l"vim" [New] 1L, 37C written
[97m[41mE173: 1 more file to edit[?2004h[?1006l[?1002l[m
[38;5;121mPress ENTER or type command to continue[?25h[?1006h[?1002h[?25l[1;2H[m[2L[1;1H. ~umrigar/cs240/bin/student.profile
[94m~                                                                               [m[24;1H[K[24;63H1,2[11CAll]2;vim (~/tmp/lab0) (1 of 2) - VIM]1;vim[1;2H[?25h[?25l[24;53H~@k[1;2H[24;53H   [1;3H[24;65H3[1;3H[?25h[?25l[24;53H~@k[1;3H[24;53H   [1;4H[24;65H4[1;4H[?25h[?25l[24;53H~@k[1;4H[24;53H   [1;5H[24;65H5[1;5H[?25h[?25l[24;53H~@k[1;5H[24;53H   [1;6H[24;65H6[1;6H[?25h[?25l[24;53H~@k[1;6H[24;53H   [1;7H[24;65H7[1;7H[?25h[?25l[24;53H~@k[1;7H[24;53H   [1;8H[24;65H8[1;8H[?25h[?25l[24;53H~@k[1;8H[24;53H   [1;9H[24;65H9[1;9H[?25h[?25l[24;53H~@k[1;9H[24;53H   [1;10H[24;65H10[1;10H[?25h[?25l[24;53H~@k[1;10H[24;53H   [1;11H[24;66H1[1;11H[?25h[?25l[24;53H~@k[1;11H[24;53H   [1;12H[24;66H2[1;12H[?25h[?25l[24;53H~@k[1;12H[24;53H   [1;13H[24;66H3[1;13H[?25h[?25l[24;53H~@k[1;13H[24;53H   [1;14H[24;66H4[1;14H[?25h[?25l[24;53H~@k[1;14H[24;53H   [1;15H[24;66H5[1;15H[?25h[?25l[24;53H~@k[1;15H[24;53H   [1;16H[24;66H6[1;16H[?25h[?25l[24;53H~@k[1;16H[24;53H   [1;17H[24;66H7[1;17H[?25h[?25l[24;53H~@k[1;17H[24;53H   [1;18H[24;66H8[1;18H[?25h[?25l[24;53H~@k[1;18H[24;53H   [1;19H[24;66H9[1;19H[?25h[?25l[24;53H~@k[1;19H[24;53H   [1;20H[24;65H20[1;20H[?25h[?25l[24;53H~@k[1;20H[24;53H   [1;21H[24;66H1[1;21H[?25h[?25l[24;53H~@k[1;21H[24;53H   [1;22H[24;66H2[1;22H[?25h[?25l[24;53H~@k[1;22H[24;53H   [1;23H[24;66H3[1;23H[?25h[?25l[24;53H~@k[1;23H[24;53H   [1;24H[24;66H4[1;24H[?25h[?25l[24;53H~@k[1;24H[24;53H   [1;25H[24;66H5[1;25H[?25h[?25l[24;53H~@k[1;25H[24;53H   [1;26H[24;66H6[1;26H[?25h[?25l[24;53H~@k[1;26H[24;53H   [1;27H[24;66H7[1;27H[?25h[?25l[24;53H~@k[1;27H[24;53H   [1;28H[24;66H8[1;28H[?25h[?25l[24;53H~@k[1;28H[24;53H   [1;29H[24;66H9[1;29H[?25h[?25l[24;53H~@k[1;29H[24;53H   [1;30H[24;65H30[1;30H[?25h[?25l[24;53H~@k[1;30H[24;53H   [1;31H[24;66H1[1;31H[?25h[?25l[24;53H~@k[1;31H[24;53H   [1;32H[24;66H2[1;32H[?25h[?25l[24;53H~@k[1;32H[24;53H   [1;33H[24;66H3[1;33H[?25h[?25l[24;53H~@k[1;33H[24;53H   [1;34H[24;66H4[1;34H[?25h[?25l[24;53H~@k[1;34H[24;53H   [1;35H[24;66H5[1;35H[?25h[?25l[24;53H~@k[1;35H[24;53H   [1;36H[24;66H6[1;36H[?25h[?25l[24;53H~@k[1;36H[24;53H   [1;36H[?25h[?25l[24;53H~@k[1;36H[24;53H   [1;36H[?25h[?25l[24;53H~@k[1;36H[24;53H   [1;36H[?25h[?25l[24;53H~@k[1;36H[24;53H   [1;36H[?25h[?25l[24;53H~@k[1;36H[24;53H   [1;36H[?25h[?25l[24;53H~@k[1;36H[24;53H   [1;36H[?25h[?25l[24;53H~@k[1;36H[24;53H   [1;36H[?25h[?25l[24;53H~@k[1;36H[24;53H   [1;36H[?25h[?25l[24;53H~@k[1;36H[24;53H   [1;36H[?25h[?25l[24;53H~@k[1;36H[24;53H   [1;36H[?25h[?25l[24;53H~@k[1;36H[24;53H   [1;36H[?25h[?25l[24;53H~@k[1;36H[24;53H   [1;36H[?25h[?25l[24;53H~@k[1;36H[24;53H   [1;36H[?25h[?25l[24;53H~@k[1;36H[24;53H   [1;36H[?25h[?25l[24;53H~@k[1;36H[24;53H   [1;36H[?25h[?25l[24;53H~@k[1;36H[24;53H   [1;36H[?25h[?25l[24;53H^[[1;36H[24;53H  [1;36H[24;53H^[[1;36H[24;53H  [1;36H[?25h[?25l[24;53H:[1;36H[24;53H[K[24;1H:[?2004h[?25hw[?25l[?25hq[?25l[?25h[?25l[?1006l[?1002l[?2004l"vim" 1L, 37C written]2;Terminal - ]1;Terminal - [23;2t[23;1t[22;2t[22;1t[23;2t[23;1t
[?2004l[?1l>[?25h[?1049l[23;0;0talongo5@g7-08:~/tmp/lab0$ vim b[K[K ~/.as[K[Kbash_history 
[?1000h[?2004h[?1049h[22;0;0t[?1h=[?2004h[1;24r[?12h[?12l[22;2t[22;1t[27m[23m[29m[m[H[2J[?25l[24;1H"~/.bash_history" 320L, 4168C[2;1H▽[6n[2;1H  [1;1H[>c]10;?]11;?[1;1Hmkdir cs120
cd cs120/
git clone https://github.com/binghamtonuniversity-cs120/lab1.git
cd lab1/
gedit partA.txt
gedit partb.txt
ls
cd cs120/
git clone https://github.com/binghamtonuniversity-cs120/project-1-spr19-antmelonn[10;1H.git
cd project-1-spr19-antmelon/
ls
cd ..
git config --global user.name "Anthony Longo"
git config --global user.email "alongo5@binghamton.edu"
cd project-1-spr19-antmelon/
touch mylib.h
ls
vim project1.c
vim project1.c
vim mylib.h
vim mylib.h
git add -A[24;63H1,1[11CTop]2;.bash_history (~) - VIM]1;.bash_history[1;1H[?25hP+q436f\P+q6b75\P+q6b64\P+q6b72\P+q6b6c\P+q2332\P+q2334\P+q2569\P+q2a37\P+q6b31\[?1000l[?1006h[?1002h[?1006l[?1002l[?1006h[?1002h[27m[23m[29m[m[H[2J[?25l[1;1Hmkdir cs120
cd cs120/
git clone https://github.com/binghamtonuniversity-cs120/lab1.git
cd lab1/
gedit partA.txt
gedit partb.txt
ls
cd cs120/
git clone https://github.com/binghamtonuniversity-cs120/project-1-spr19-antmelonn[10;1H.git
cd project-1-spr19-antmelon/
ls
cd ..
git config --global user.name "Anthony Longo"
git config --global user.email "alongo5@binghamton.edu"
cd project-1-spr19-antmelon/
touch mylib.h
ls
vim project1.c
vim project1.c
vim mylib.h
vim mylib.h
git add -A[24;63H1,1[11CTop"~/.bash_history" 320L, 4168C[1;1H[?25h[?25l[24;53H^[[1;1H[24;53H  [1;1H[24;53H^[[1;1H[24;53H  [1;1H[?25h[?25l[24;53H:[1;1H[24;1H[K[24;1H:[?2004h[?25hw[?25l[?25h[?25l[24;2H[K[24;2H[?25hq[?25l[?25h[?25l[?1006l[?1002l[?2004l]2;Terminal - ]1;Terminal - [23;2t[23;1t[22;2t[22;1t[23;2t[23;1t[24;1H[K[24;1H[?2004l[?1l>[?25h[?1049l[23;0;0talongo5@g7-08:~/tmp/lab0$ vim ~/.bashrc
[?1000h[?2004h[?1049h[22;0;0t[?1h=[?2004h[1;24r[?12h[?12l[22;2t[22;1t[27m[23m[29m[m[H[2J[?25l[24;1H"~/.bashrc" [New File][2;1H▽[6n[2;1H  [1;1H[>c]10;?]11;?[2;1H[94m~                                                                               [3;1H~                                                                               [4;1H~                                                                               [5;1H~                                                                               [6;1H~                                                                               [7;1H~                                                                               [8;1H~                                                                               [9;1H~                                                                               [10;1H~                                                                               [11;1H~                                                                               [12;1H~                                                                               [13;1H~                                                                               [14;1H~                                                                               [15;1H~                                                                               [16;1H~                                                                               [17;1H~                                                                               [18;1H~                                                                               [19;1H~                                                                               [20;1H~                                                                               [21;1H~                                                                               [22;1H~                                                                               [23;1H~                                                                               [m[24;63H0,0-1[9CAll]2;.bashrc (~) - VIM]1;.bashrc[1;1H[?25hP+q436f\P+q6b75\P+q6b64\P+q6b72\P+q6b6c\P+q2332\P+q2334\P+q2569\P+q2a37\P+q6b31\[?1000l[?1006h[?1002h[?1006l[?1002l[?1006h[?1002h[27m[23m[29m[m[H[2J[?25l[2;1H[94m~                                                                               [3;1H~                                                                               [4;1H~                                                                               [5;1H~                                                                               [6;1H~                                                                               [7;1H~                                                                               [8;1H~                                                                               [9;1H~                                                                               [10;1H~                                                                               [11;1H~                                                                               [12;1H~                                                                               [13;1H~                                                                               [14;1H~                                                                               [15;1H~                                                                               [16;1H~                                                                               [17;1H~                                                                               [18;1H~                                                                               [19;1H~                                                                               [20;1H~                                                                               [21;1H~                                                                               [22;1H~                                                                               [23;1H~                                                                               [m[24;63H0,0-1[9CAll"~/.bashrc" [New File][1;1H[?25h[?25l[24;53Hi[1;1H[24;53H [1;1H[24;1H[1m-- INSERT --[m[24;13H[K[24;63H0,1[11CAll[1;1H[?25h[?25l.[24;63H1,2]2;.bashrc + (~) - VIM]1;.bashrc[1;2H[?25h[?25l[93m. [m[24;65H3[1;3H[?25h[?25l~umrigar/cs240/bin/student.profile[24;66H7[1;37H[?25h[24;1H[K[1;36H[?25l[24;53H^[[1;36H[24;53H  [1;37H[24;63H1,36[10CAll[1;36H[?25h[?25l[24;53H:[1;36H[24;53H[K[24;1H:[?2004h[?25hw[?25l[?25hq[?25l[?25h[?25l[?1006l[?1002l[?2004l"~/.bashrc" [New] 1L, 37C written]2;Terminal - ]1;Terminal - [23;2t[23;1t[22;2t[22;1t[23;2t[23;1t
[?2004l[?1l>[?25h[?1049l[23;0;0talongo5@g7-08:~/tmp/lab0$ vim ~/.bashrc_history [3Pvim ~/.bashrc[3P~/.profile
[?1000h[?2004h[?1049h[22;0;0t[?1h=[?2004h[1;24r[?12h[?12l[22;2t[22;1t[27m[23m[29m[m[H[2J[?25l[24;1H"~/.profile" 1L, 34C[2;1H▽[6n[2;1H  [1;1H[>c]10;?]11;?[1;1Humrigar/cs240/bin/student.profile
[94m~                                                                               [3;1H~                                                                               [4;1H~                                                                               [5;1H~                                                                               [6;1H~                                                                               [7;1H~                                                                               [8;1H~                                                                               [9;1H~                                                                               [10;1H~                                                                               [11;1H~                                                                               [12;1H~                                                                               [13;1H~                                                                               [14;1H~                                                                               [15;1H~                                                                               [16;1H~                                                                               [17;1H~                                                                               [18;1H~                                                                               [19;1H~                                                                               [20;1H~                                                                               [21;1H~                                                                               [22;1H~                                                                               [23;1H~                                                                               [m[24;63H1,33[10CAll]2;.profile (~) - VIM]1;.profile[1;33H[?25hP+q436f\P+q6b75\P+q6b64\P+q6b72\P+q6b6c\P+q2332\P+q2334\P+q2569\P+q2a37\P+q6b31\[?1000l[?1006h[?1002h[?1006l[?1002l[?1006h[?1002h[27m[23m[29m[m[H[2J[?25l[1;1Humrigar/cs240/bin/student.profile
[94m~                                                                               [3;1H~                                                                               [4;1H~                                                                               [5;1H~                                                                               [6;1H~                                                                               [7;1H~                                                                               [8;1H~                                                                               [9;1H~                                                                               [10;1H~                                                                               [11;1H~                                                                               [12;1H~                                                                               [13;1H~                                                                               [14;1H~                                                                               [15;1H~                                                                               [16;1H~                                                                               [17;1H~                                                                               [18;1H~                                                                               [19;1H~                                                                               [20;1H~                                                                               [21;1H~                                                                               [22;1H~                                                                               [23;1H~                                                                               [m[24;63H1,33[10CAll"~/.profile" 1L, 34C[1;33H[?25h[?25l[24;53H~@k[1;33H[24;53H   [1;32H[24;66H2[1;32H[?25h[?25l[24;53H~@k[1;32H[24;53H   [1;31H[24;66H1[1;31H[?25h[?25l[24;53H~@k[1;31H[24;53H   [1;30H[24;66H0[1;30H[?25h[?25l[24;53H~@k[1;30H[24;53H   [1;29H[24;65H29[1;29H[?25h[?25l[24;53H~@k[1;29H[24;53H   [1;28H[24;66H8[1;28H[?25h[?25l[24;53H~@k[1;28H[24;53H   [1;27H[24;66H7[1;27H[?25h[?25l[24;53H~@k[1;27H[24;53H   [1;26H[24;66H6[1;26H[?25h[?25l[24;53H~@k[1;26H[24;53H   [1;25H[24;66H5[1;25H[?25h[?25l[24;53H~@k[1;25H[24;53H   [1;24H[24;66H4[1;24H[?25h[?25l[24;53H~@k[1;24H[24;53H   [1;23H[24;66H3[1;23H[?25h[?25l[24;53H~@k[1;23H[24;53H   [1;22H[24;66H2[1;22H[?25h[?25l[24;53H~@k[1;22H[24;53H   [1;21H[24;66H1[1;21H[?25h[?25l[24;53H~@k[1;21H[24;53H   [1;20H[24;66H0[1;20H[?25h[?25l[24;53H~@k[1;20H[24;53H   [1;19H[24;65H19[1;19H[?25h[?25l[24;53H~@k[1;19H[24;53H   [1;18H[24;66H8[1;18H[?25h[?25l[24;53H~@k[1;18H[24;53H   [1;17H[24;66H7[1;17H[?25h[?25l[24;53H~@k[1;17H[24;53H   [1;16H[24;66H6[1;16H[?25h[?25l[24;53H~@k[1;16H[24;53H   [1;15H[24;66H5[1;15H[?25h[?25l[24;53H~@k[1;15H[24;53H   [1;14H[24;66H4[1;14H[?25h[?25l[24;53H~@k[1;14H[24;53H   [1;13H[24;66H3[1;13H[?25h[?25l[24;53H~@k[1;13H[24;53H   [1;12H[24;66H2[1;12H[?25h[?25l[24;53H~@k[1;12H[24;53H   [1;11H[24;66H1[1;11H[?25h[?25l[24;53H~@k[1;11H[24;53H   [1;10H[24;66H0[1;10H[?25h[?25l[24;53H~@k[1;10H[24;53H   [1;9H[24;65H9 [1;9H[?25h[?25l[24;53H~@k[1;9H[24;53H   [1;8H[24;65H8[1;8H[?25h[?25l[24;53H~@k[1;8H[24;53H   [1;7H[24;65H7[1;7H[?25h[?25l[24;53H~@k[1;7H[24;53H   [1;6H[24;65H6[1;6H[?25h[?25l[24;53H~@k[1;6H[24;53H   [1;5H[24;65H5[1;5H[?25h[?25l[24;53H~@k[1;5H[24;53H   [1;4H[24;65H4[1;4H[?25h[?25l[24;53H~@k[1;4H[24;53H   [1;3H[24;65H3[1;3H[?25h[?25l[24;53H~@k[1;3H[24;53H   [1;2H[24;65H2[1;2H[?25h[?25l[24;53H~@k[1;2H[24;53H   [1;1H[24;65H1[1;1H[?25h[?25l[24;53H~@k[1;1H[24;53H   [1;1H[?25h[?25l[24;53H~@k[1;1H[24;53H   [1;1H[?25h[?25l[24;53H~@k[1;1H[24;53H   [1;1H[?25h[?25l[24;53H~@k[1;1H[24;53H   [1;1H[?25h[?25l[24;53H~@k[1;1H[24;53H   [1;1H[?25h[?25l[24;53H~@k[1;1H[24;53H   [1;1H[?25h[?25l[24;53Hi[1;1H[24;53H [1;1H[24;1H[1m-- INSERT --[m[24;14H[K[24;63H1,1[11CAll[1;1H[?25h[?25l.umrigar/cs240/bin/student.profile[24;65H2]2;.profile + (~) - VIM]1;.profile[1;2H[?25h[?25l[93m. [mumrigar/cs240/bin/student.profile[24;65H3[1;3H[?25h[?25l~umrigar/cs240/bin/student.profile[24;65H4[1;4H[?25h[24;1H[K[1;3H[?25l[24;53H^[[1;3H[24;53H  [1;4H[24;63H1,3[11CAll[1;3H[?25h[?25l[24;53H:[1;3H[24;53H[K[24;1H:[?2004h[?25hw[?25l[?25hq[?25l[?25h[?25l[?1006l[?1002l[?2004l"~/.profile" 1L, 37C written]2;Terminal - ]1;Terminal - [23;2t[23;1t[22;2t[22;1t[23;2t[23;1t
[?2004l[?1l>[?25h[?1049l[23;0;0talongo5@g7-08:~/tmp/lab0$ vim ~/.profile[1Pbashrc
[?1000h[?2004h[?1049h[22;0;0t[?1h=[?2004h[1;24r[?12h[?12l[22;2t[22;1t[27m[23m[29m[m[H[2J[?25l[24;1H"~/.bashrc" 1L, 37C[2;1H▽[6n[2;1H  [1;1H[>c]10;?]11;?[1;1H[38;5;130m. [m~umrigar/cs240/bin/student.profile
[94m~                                                                               [3;1H~                                                                               [4;1H~                                                                               [5;1H~                                                                               [6;1H~                                                                               [7;1H~                                                                               [8;1H~                                                                               [9;1H~                                                                               [10;1H~                                                                               [11;1H~                                                                               [12;1H~                                                                               [13;1H~                                                                               [14;1H~                                                                               [15;1H~                                                                               [16;1H~                                                                               [17;1H~                                                                               [18;1H~                                                                               [19;1H~                                                                               [20;1H~                                                                               [21;1H~                                                                               [22;1H~                                                                               [23;1H~                                                                               [m[24;63H1,36[10CAll]2;.bashrc (~) - VIM]1;.bashrc[1;36H[?25hP+q436f\P+q6b75\P+q6b64\P+q6b72\P+q6b6c\P+q2332\P+q2334\P+q2569\P+q2a37\P+q6b31\[?1000l[?1006h[?1002h[?1006l[?1002l[?1006h[?1002h[27m[23m[29m[m[H[2J[?25l[1;1H[93m. [m~umrigar/cs240/bin/student.profile
[94m~                                                                               [3;1H~                                                                               [4;1H~                                                                               [5;1H~                                                                               [6;1H~                                                                               [7;1H~                                                                               [8;1H~                                                                               [9;1H~                                                                               [10;1H~                                                                               [11;1H~                                                                               [12;1H~                                                                               [13;1H~                                                                               [14;1H~                                                                               [15;1H~                                                                               [16;1H~                                                                               [17;1H~                                                                               [18;1H~                                                                               [19;1H~                                                                               [20;1H~                                                                               [21;1H~                                                                               [22;1H~                                                                               [23;1H~                                                                               [m[24;63H1,36[10CAll"~/.bashrc" 1L, 37C[1;36H[?25h[?25l[24;53H^[[1;36H[24;53H  [1;36H[24;53H^[[1;36H[24;53H  [1;36H[?25h[?25l[24;53H:[1;36H[24;1H[K[24;1H:[?2004h[?25hw[?25l[?25hq[?25l[?25h[?25l[?1006l[?1002l[?2004l"~/.bashrc" 1L, 37C written]2;Terminal - ]1;Terminal - [23;2t[23;1t[22;2t[22;1t[23;2t[23;1t
[?2004l[?1l>[?25h[?1049l[23;0;0talongo5@g7-08:~/tmp/lab0$ vim ~/.bashrcprofile
[?1000h[?2004h[?1049h[22;0;0t[?1h=[?2004h[1;24r[?12h[?12l[22;2t[22;1t[27m[23m[29m[m[H[2J[?25l[24;1H"~/.profile" 1L, 37C[2;1H▽[6n[2;1H  [1;1H[>c]10;?]11;?[1;1H[38;5;130m. [m~umrigar/cs240/bin/student.profile
[94m~                                                                               [3;1H~                                                                               [4;1H~                                                                               [5;1H~                                                                               [6;1H~                                                                               [7;1H~                                                                               [8;1H~                                                                               [9;1H~                                                                               [10;1H~                                                                               [11;1H~                                                                               [12;1H~                                                                               [13;1H~                                                                               [14;1H~                                                                               [15;1H~                                                                               [16;1H~                                                                               [17;1H~                                                                               [18;1H~                                                                               [19;1H~                                                                               [20;1H~                                                                               [21;1H~                                                                               [22;1H~                                                                               Script started on 2020-01-23 13:34:36-05:00 [TERM="xterm-256color" TTY="/dev/pts/0" COLUMNS="80" LINES="24"]
bash: /home/umrigar/cs240/bin/student.profile: Permission denied
alongo5@g7-08:/import/linux/home1/alongo5/tmp/lab0$ vim ~/.bash_p[K[K[K[K[K[Kbashrc [K
[?1000h[?2004h[?1049h[22;0;0t[?1h=[?2004h[1;24r[?12h[?12l[22;2t[22;1t[27m[23m[29m[m[H[2J[?25l[24;1H"~/.bashrc" 1L, 35C[2;1H▽[6n[2;1H  [1;1H[>c]10;?]11;?[1;1H~umrigar/cs240/bin/student.profile
[94m~                                                                               [3;1H~                                                                               [4;1H~                                                                               [5;1H~                                                                               [6;1H~                                                                               [7;1H~                                                                               [8;1H~                                                                               [9;1H~                                                                               [10;1H~                                                                               [11;1H~                                                                               [12;1H~                                                                               [13;1H~                                                                               [14;1H~                                                                               [15;1H~                                                                               [16;1H~                                                                               [17;1H~                                                                               [18;1H~                                                                               [19;1H~                                                                               [20;1H~                                                                               [21;1H~                                                                               [22;1H~                                                                               [23;1H~                                                                               [m[24;63H1,1[11CAll]2;.bashrc (~) - VIM]1;.bashrc[1;1H[?25hP+q436f\P+q6b75\P+q6b64\P+q6b72\P+q6b6c\P+q2332\P+q2334\P+q2569\P+q2a37\P+q6b31\[?1000l[?1006h[?1002h[?1006l[?1002l[?1006h[?1002h[27m[23m[29m[m[H[2J[?25l[1;1H~umrigar/cs240/bin/student.profile
[94m~                                                                               [3;1H~                                                                               [4;1H~                                                                               [5;1H~                                                                               [6;1H~                                                                               [7;1H~                                                                               [8;1H~                                                                               [9;1H~                                                                               [10;1H~                                                                               [11;1H~                                                                               [12;1H~                                                                               [13;1H~                                                                               [14;1H~                                                                               [15;1H~                                                                               [16;1H~                                                                               [17;1H~                                                                               [18;1H~                                                                               [19;1H~                                                                               [20;1H~                                                                               [21;1H~                                                                               [22;1H~                                                                               [23;1H~                                                                               [m[24;63H1,1[11CAll"~/.bashrc" 1L, 35C[1;1H[?25h[?25l[24;53Hi[1;1H[24;53H [1;1H[24;1H[1m-- INSERT --[m[24;13H[K[24;63H1,1[11CAll[1;1H[?25h[?25l.~umrigar/cs240/bin/student.profile[24;65H2]2;.bashrc + (~) - VIM]1;.bashrc[1;2H[?25h[?25l[93m. [m~umrigar/cs240/bin/student.profile[24;65H3[1;3H[?25h[24;1H[K[1;2H[?25l[24;53H^[[1;2H[24;53H  [1;3H[24;63H1,2[11CAll[1;2H[?25h[?25l[24;53H?[1;2H[24;53H[K[24;1H?[?2004h[?25hw[?25l[60C1,2[11CAll[24;63H[K[24;3H[?25hq[?25l[59C1,2[11CAll[24;63H[K[24;4H[?25h[?25l[24;3H[K[24;63H1,2[11CAll[24;63H[K[24;3H[?25h[?25l[24;2H[K[24;63H1,2[11CAll[24;63H[K[24;2H[?25h [?25l[1;2H[24;63H1,2[11CAll[1;2H[?25h[?25l[24;53H:[1;2H[24;53H[K[24;1H:[?2004h[?25hw[?25l[?25hq[?25l[?25h[?25l[?1006l[?1002l[?2004l"~/.bashrc" 1L, 37C written]2;Terminal - ]1;Terminal - [23;2t[23;1t[22;2t[22;1t[23;2t[23;1t
[?2004l[?1l>[?25h[?1049l[23;0;0talongo5@g7-08:/import/linux/home1/alongo5/tmp/lab0$ ssh r[Kalongo5@remote
Linux remote07 4.19.0-5-amd64 #1 SMP Debian 4.19.37-5 (2019-06-19) x86_64

The programs included with the Debian GNU/Linux system are free software;
the exact distribution terms for each program are described in the
individual files in /usr/share/doc/*/copyright.

Debian GNU/Linux comes with ABSOLUTELY NO WARRANTY, to the extent
permitted by applicable law.
Last login: Thu Jan 23 13:28:14 2020 from 128.226.119.250
-bash: /home/umrigar/cs240/bin/student.profile: Permission denied
alongo5@remote07:~$ exit
logout
Connection to remote closed.
alongo5@g7-08:/import/linux/home1/alongo5/tmp/lab0$ aah al\[K[K[K[K[K[K[Kssh alongo5@remote.cs.bingha mton.edu/~umrigar/git[K[K[K[K[K[K[K[K[K[K[K[K[K[K[K[K[K[K[K[K[K[A[C[C[C[C[C[C[C[C[C[C[C[C[C[C[C[C[C[C[C[C[C[C[C[C[C[C[C[C[C[C[C[C[C[C[C[C[C[C[C[C[C[C[C[C[C[C[C[C[C[C[C[C[C[C[C[C[C[C[C[C[C[C[C[C[C[C[C[C[C[C[C[C[C[C[C[C[C[C[C[K
[K[A[C[C[C[C[C[C[C[C[C[C[C[C[C[C[C[C[C[C[C[C[C[C[C[C[C[C[C[C[C[C[C[C[C[C[C[C[C[C[C[C[C[C[C[C[C[C[C[C[C[C[C[C[C[C[C[C[C[C[C[C[C[C[C[C[C[C[C[C[C[C[C[C[C[C[C[C[C[C[C[K[K[K[K[K[K[K[K[K[K[K[K[K[K[K[K[K[K[K[K[K[K[K[K[K[K[Kssh alongo5@remote.cs.binghm [A[C[C[C[C[C[C[C[C[C[C[C[C[C[C[C[C[C[C[C[C[C[C[C[C[C[C[C[C[C[C[C[C[C[C[C[C[C[C[C[C[C[C[C[C[C[C[C[C[C[C[C[C[C[C[C[C[C[C[C[C[C[C[C[C[C[C[C[C[C[C[C[C[C[C[C[C[C[C[C[K
[K[A[C[C[C[C[C[C[C[C[C[C[C[C[C[C[C[C[C[C[C[C[C[C[C[C[C[C[C[C[C[C[C[C[C[C[C[C[C[C[C[C[C[C[C[C[C[C[C[C[C[C[C[C[C[C[C[C[C[C[C[C[C[C[C[C[C[C[C[C[C[C[C[C[C[C[C[C[C[C[Ca [A[C[C[C[C[C[C[C[C[C[C[C[C[C[C[C[C[C[C[C[C[C[C[C[C[C[C[C[C[C[C[C[C[C[C[C[C[C[C[C[C[C[C[C[C[C[C[C[C[C[C[C[C[C[C[C[C[C[C[C[C[C[C[C[C[C[C[C[C[C[C[C[C[C[C[C[C[C[C[C[K
[K[A[C[C[C[C[C[C[C[C[C[C[C[C[C[C[C[C[C[C[C[C[C[C[C[C[C[C[C[C[C[C[C[C[C[C[C[C[C[C[C[C[C[C[C[C[C[C[C[C[C[C[C[C[C[C[C[C[C[C[C[C[C[C[C[C[C[C[C[C[C[C[C[C[C[C[C[C[C[C[C[Kha mtoned[K[K.edu[K[K[K[K[K[K[K[K[A[C[C[C[C[C[C[C[C[C[C[C[C[C[C[C[C[C[C[C[C[C[C[C[C[C[C[C[C[C[C[C[C[C[C[C[C[C[C[C[C[C[C[C[C[C[C[C[C[C[C[C[C[C[C[C[C[C[C[C[C[C[C[C[C[C[C[C[C[C[C[C[C[C[C[C[C[C[C[C[K
[K[A[C[C[C[C[C[C[C[C[C[C[C[C[C[C[C[C[C[C[C[C[C[C[C[C[C[C[C[C[C[C[C[C[C[C[C[C[C[C[C[C[C[C[C[C[C[C[C[C[C[C[C[C[C[C[C[C[C[C[C[C[C[C[C[C[C[C[C[C[C[C[C[C[C[C[C[C[C[C[C[K[K[K[K[K[K[K[K[K[K[K[K[K[K[K[K[K[K[K[K[K[K[K[K[K[K[Kmkdir ~[K-p ~/projects
alongo5@g7-08:/import/linux/home1/alongo5/tmp/lab0$ cd ori[K[K[Kpro[K[K[K[K[K[Kcd ~/projects/
alongo5@g7-08:~/projects$ git clone ssh://user@remote.cs.binghamton.edu/~umrigar/git-repos/cs240.git
Cloning into 'cs240'...
The authenticity of host 'remote.cs.binghamton.edu (128.226.114.200)' can't be established.
ECDSA key fingerprint is SHA256:UEIh1TASIC96TC1hhxVbkVS0DrddNKHk7Q2nzgDCt+Y.
Are you sure you want to continue connecting (yes/no)? no
Host key verification failed.
fatal: Could not read from remote repository.

Please make sure you have the correct access rights
and the repository exists.
alongo5@g7-08:~/projects$ git clone ssh://user@remote.cs.binghamton.edu/~umrigar/git-repos/cs240.git[A[C[C[C[C[C[C[K
[K[A[C[C[C[C[C[C[C[C[C[C[C[C[C[C[C[C[C[C[C[C[C[C[C[C[C[Cls
alongo5@g7-08:~/projects$ \ls
alongo5@g7-08:~/projects$ ls
alongo5@g7-08:~/projects$ git clone ssh://alop[Kngo5@remote.cs.binghamton.edy[Ku/~umgi rar/git-repos/cs240.git
Cloning into 'cs240'...
The authenticity of host 'remote.cs.binghamton.edu (128.226.114.204)' can't be established.
ECDSA key fingerprint is SHA256:UEIh1TASIC96TC1hhxVbkVS0DrddNKHk7Q2nzgDCt+Y.
Are you sure you want to continue connecting (yes/no)? yes
Warning: Permanently added 'remote.cs.binghamton.edu,128.226.114.204' (ECDSA) to the list of known hosts.
/home/alongo5/.bashrc: line 1: /home/umrigar/cs240/bin/student.profile: Permission denied
fatal: '~umgirar/git-repos/cs240.git' does not appear to be a git repository
fatal: Could not read from remote repository.

Please make sure you have the correct access rights
and the repository exists.
alongo5@g7-08:~/projects$ ls
alongo5@g7-08:~/projects$ git clone ssh://alongo5@remote.cs.binghamton.edu/~umri gar/git-repos/cs240.git
Cloning into 'cs240'...
/home/alongo5/.bashrc: line 1: /home/umrigar/cs240/bin/student.profile: Permission denied
remote: Enumerating objects: 210, done.[K
remote: Counting objects:   0% (1/210)   [Kremote: Counting objects:   1% (3/210)   [Kremote: Counting objects:   2% (5/210)   [Kremote: Counting objects:   3% (7/210)   [Kremote: Counting objects:   4% (9/210)   [Kremote: Counting objects:   5% (11/210)   [Kremote: Counting objects:   6% (13/210)   [Kremote: Counting objects:   7% (15/210)   [Kremote: Counting objects:   8% (17/210)   [Kremote: Counting objects:   9% (19/210)   [Kremote: Counting objects:  10% (21/210)   [Kremote: Counting objects:  11% (24/210)   [Kremote: Counting objects:  12% (26/210)   [Kremote: Counting objects:  13% (28/210)   [Kremote: Counting objects:  14% (30/210)   [Kremote: Counting objects:  15% (32/210)   [Kremote: Counting objects:  16% (34/210)   [Kremote: Counting objects:  17% (36/210)   [Kremote: Counting objects:  18% (38/210)   [Kremote: Counting objects:  19% (40/210)   [Kremote: Counting objects:  20% (42/210)   [Kremote: Counting objects:  21% (45/210)   [Kremote: Counting objects:  22% (47/210)   [Kremote: Counting objects:  23% (49/210)   [Kremote: Counting objects:  24% (51/210)   [Kremote: Counting objects:  25% (53/210)   [Kremote: Counting objects:  26% (55/210)   [Kremote: Counting objects:  27% (57/210)   [Kremote: Counting objects:  28% (59/210)   [Kremote: Counting objects:  29% (61/210)   [Kremote: Counting objects:  30% (63/210)   [Kremote: Counting objects:  31% (66/210)   [Kremote: Counting objects:  32% (68/210)   [Kremote: Counting objects:  33% (70/210)   [Kremote: Counting objects:  34% (72/210)   [Kremote: Counting objects:  35% (74/210)   [Kremote: Counting objects:  36% (76/210)   [Kremote: Counting objects:  37% (78/210)   [Kremote: Counting objects:  38% (80/210)   [Kremote: Counting objects:  39% (82/210)   [Kremote: Counting objects:  40% (84/210)   [Kremote: Counting objects:  41% (87/210)   [Kremote: Counting objects:  42% (89/210)   [Kremote: Counting objects:  43% (91/210)   [Kremote: Counting objects:  44% (93/210)   [Kremote: Counting objects:  45% (95/210)   [Kremote: Counting objects:  46% (97/210)   [Kremote: Counting objects:  47% (99/210)   [Kremote: Counting objects:  48% (101/210)   [Kremote: Counting objects:  49% (103/210)   [Kremote: Counting objects:  50% (105/210)   [Kremote: Counting objects:  51% (108/210)   [Kremote: Counting objects:  52% (110/210)   [Kremote: Counting objects:  53% (112/210)   [Kremote: Counting objects:  54% (114/210)   [Kremote: Counting objects:  55% (116/210)   [Kremote: Counting objects:  56% (118/210)   [Kremote: Counting objects:  57% (120/210)   [Kremote: Counting objects:  58% (122/210)   [Kremote: Counting objects:  59% (124/210)   [Kremote: Counting objects:  60% (126/210)   [Kremote: Counting objects:  61% (129/210)   [Kremote: Counting objects:  62% (131/210)   [Kremote: Counting objects:  63% (133/210)   [Kremote: Counting objects:  64% (135/210)   [Kremote: Counting objects:  65% (137/210)   [Kremote: Counting objects:  66% (139/210)   [Kremote: Counting objects:  67% (141/210)   [Kremote: Counting objects:  68% (143/210)   [Kremote: Counting objects:  69% (145/210)   [Kremote: Counting objects:  70% (147/210)   [Kremote: Counting objects:  71% (150/210)   [Kremote: Counting objects:  72% (152/210)   [Kremote: Counting objects:  73% (154/210)   [Kremote: Counting objects:  74% (156/210)   [Kremote: Counting objects:  75% (158/210)   [Kremote: Counting objects:  76% (160/210)   [Kremote: Counting objects:  77% (162/210)   [Kremote: Counting objects:  78% (164/210)   [Kremote: Counting objects:  79% (166/210)   [Kremote: Counting objects:  80% (168/210)   [Kremote: Counting objects:  81% (171/210)   [Kremote: Counting objects:  82% (173/210)   [Kremote: Counting objects:  83% (175/210)   [Kremote: Counting objects:  84% (177/210)   [Kremote: Counting objects:  85% (179/210)   [Kremote: Counting objects:  86% (181/210)   [Kremote: Counting objects:  87% (183/210)   [Kremote: Counting objects:  88% (185/210)   [Kremote: Counting objects:  89% (187/210)   [Kremote: Counting objects:  90% (189/210)   [Kremote: Counting objects:  91% (192/210)   [Kremote: Counting objects:  92% (194/210)   [Kremote: Counting objects:  93% (196/210)   [Kremote: Counting objects:  94% (198/210)   [Kremote: Counting objects:  95% (200/210)   [Kremote: Counting objects:  96% (202/210)   [Kremote: Counting objects:  97% (204/210)   [Kremote: Counting objects:  98% (206/210)   [Kremote: Counting objects:  99% (208/210)   [Kremote: Counting objects: 100% (210/210)   [Kremote: Counting objects: 100% (210/210), done.[K
remote: Compressing objects:   0% (1/201)   [Kremote: Compressing objects:   1% (3/201)   [Kremote: Compressing objects:   2% (5/201)   [Kremote: Compressing objects:   3% (7/201)   [Kremote: Compressing objects:   4% (9/201)   [Kremote: Compressing objects:   5% (11/201)   [Kremote: Compressing objects:   6% (13/201)   [Kremote: Compressing objects:   7% (15/201)   [Kremote: Compressing objects:   8% (17/201)   [Kremote: Compressing objects:   9% (19/201)   [Kremote: Compressing objects:  10% (21/201)   [Kremote: Compressing objects:  11% (23/201)   [Kremote: Compressing objects:  12% (25/201)   [Kremote: Compressing objects:  13% (27/201)   [Kremote: Compressing objects:  14% (29/201)   [Kremote: Compressing objects:  15% (31/201)   [Kremote: Compressing objects:  16% (33/201)   [Kremote: Compressing objects:  17% (35/201)   [Kremote: Compressing objects:  18% (37/201)   [Kremote: Compressing objects:  19% (39/201)   [Kremote: Compressing objects:  20% (41/201)   [Kremote: Compressing objects:  21% (43/201)   [Kremote: Compressing objects:  22% (45/201)   [Kremote: Compressing objects:  23% (47/201)   [Kremote: Compressing objects:  24% (49/201)   [Kremote: Compressing objects:  25% (51/201)   [Kremote: Compressing objects:  26% (53/201)   [Kremote: Compressing objects:  27% (55/201)   [Kremote: Compressing objects:  28% (57/201)   [Kremote: Compressing objects:  29% (59/201)   [Kremote: Compressing objects:  30% (61/201)   [Kremote: Compressing objects:  31% (63/201)   [Kremote: Compressing objects:  32% (65/201)   [Kremote: Compressing objects:  33% (67/201)   [Kremote: Compressing objects:  34% (69/201)   [Kremote: Compressing objects:  35% (71/201)   [Kremote: Compressing objects:  36% (73/201)   [Kremote: Compressing objects:  37% (75/201)   [Kremote: Compressing objects:  38% (77/201)   [Kremote: Compressing objects:  39% (79/201)   [Kremote: Compressing objects:  40% (81/201)   [Kremote: Compressing objects:  41% (83/201)   [Kremote: Compressing objects:  42% (85/201)   [Kremote: Compressing objects:  43% (87/201)   [Kremote: Compressing objects:  44% (89/201)   [Kremote: Compressing objects:  45% (91/201)   [Kremote: Compressing objects:  46% (93/201)   [Kremote: Compressing objects:  47% (95/201)   [Kremote: Compressing objects:  48% (97/201)   [Kremote: Compressing objects:  49% (99/201)   [Kremote: Compressing objects:  50% (101/201)   [Kremote: Compressing objects:  51% (103/201)   [Kremote: Compressing objects:  52% (105/201)   [Kremote: Compressing objects:  53% (107/201)   [Kremote: Compressing objects:  54% (109/201)   [Kremote: Compressing objects:  55% (111/201)   [Kremote: Compressing objects:  56% (113/201)   [Kremote: Compressing objects:  57% (115/201)   [Kremote: Compressing objects:  58% (117/201)   [Kremote: Compressing objects:  59% (119/201)   [Kremote: Compressing objects:  60% (121/201)   [Kremote: Compressing objects:  61% (123/201)   [Kremote: Compressing objects:  62% (125/201)   [Kremote: Compressing objects:  63% (127/201)   [Kremote: Compressing objects:  64% (129/201)   [Kremote: Compressing objects:  65% (131/201)   [Kremote: Compressing objects:  66% (133/201)   [Kremote: Compressing objects:  67% (135/201)   [Kremote: Compressing objects:  68% (137/201)   [Kremote: Compressing objects:  69% (139/201)   [Kremote: Compressing objects:  70% (141/201)   [Kremote: Compressing objects:  71% (143/201)   [Kremote: Compressing objects:  72% (145/201)   [Kremote: Compressing objects:  73% (147/201)   [Kremote: Compressing objects:  74% (149/201)   [Kremote: Compressing objects:  75% (151/201)   [Kremote: Compressing objects:  76% (153/201)   [Kremote: Compressing objects:  77% (155/201)   [Kremote: Compressing objects:  78% (157/201)   [Kremote: Compressing objects:  79% (159/201)   [Kremote: Compressing objects:  80% (161/201)   [Kremote: Compressing objects:  81% (163/201)   [Kremote: Compressing objects:  82% (165/201)   [Kremote: Compressing objects:  83% (167/201)   [Kremote: Compressing objects:  84% (169/201)   [Kremote: Compressing objects:  85% (171/201)   [Kremote: Compressing objects:  86% (173/201)   [Kremote: Compressing objects:  87% (175/201)   [Kremote: Compressing objects:  88% (177/201)   [Kremote: Compressing objects:  89% (179/201)   [Kremote: Compressing objects:  90% (181/201)   [Kremote: Compressing objects:  91% (183/201)   [Kremote: Compressing objects:  92% (185/201)   [Kremote: Compressing objects:  93% (187/201)   [Kremote: Compressing objects:  94% (189/201)   [Kremote: Compressing objects:  95% (191/201)   [Kremote: Compressing objects:  96% (193/201)   [Kremote: Compressing objects:  97% (195/201)   [Kremote: Compressing objects:  98% (197/201)   [Kremote: Compressing objects:  99% (199/201)   [Kremote: Compressing objects: 100% (201/201)   [Kremote: Compressing objects: 100% (201/201), done.[K
Receiving objects:   0% (1/210)   Receiving objects:   1% (3/210)   Receiving objects:   2% (5/210)   Receiving objects:   3% (7/210)   Receiving objects:   4% (9/210)   Receiving objects:   5% (11/210)   Receiving objects:   6% (13/210)   Receiving objects:   7% (15/210)   Receiving objects:   8% (17/210)   Receiving objects:   9% (19/210)   Receiving objects:  10% (21/210)   Receiving objects:  11% (24/210)   Receiving objects:  12% (26/210)   Receiving objects:  13% (28/210)   Receiving objects:  14% (30/210)   Receiving objects:  15% (32/210)   Receiving objects:  16% (34/210)   Receiving objects:  17% (36/210)   Receiving objects:  18% (38/210)   Receiving objects:  19% (40/210)   Receiving objects:  20% (42/210)   Receiving objects:  21% (45/210)   Receiving objects:  22% (47/210)   Receiving objects:  23% (49/210)   Receiving objects:  24% (51/210)   Receiving objects:  25% (53/210)   Receiving objects:  26% (55/210)   Receiving objects:  27% (57/210)   Receiving objects:  28% (59/210)   Receiving objects:  29% (61/210)   Receiving objects:  30% (63/210)   Receiving objects:  31% (66/210)   Receiving objects:  32% (68/210)   Receiving objects:  33% (70/210)   Receiving objects:  34% (72/210)   Receiving objects:  35% (74/210)   Receiving objects:  36% (76/210)   Receiving objects:  37% (78/210)   Receiving objects:  38% (80/210)   Receiving objects:  39% (82/210)   Receiving objects:  40% (84/210)   Receiving objects:  41% (87/210)   Receiving objects:  42% (89/210)   Receiving objects:  43% (91/210)   Receiving objects:  44% (93/210)   Receiving objects:  45% (95/210)   Receiving objects:  46% (97/210)   Receiving objects:  47% (99/210)   Receiving objects:  48% (101/210)   Receiving objects:  49% (103/210)   Receiving objects:  50% (105/210)   Receiving objects:  51% (108/210)   Receiving objects:  52% (110/210)   Receiving objects:  53% (112/210)   Receiving objects:  54% (114/210)   Receiving objects:  55% (116/210)   Receiving objects:  56% (118/210)   Receiving objects:  57% (120/210)   Receiving objects:  58% (122/210)   Receiving objects:  59% (124/210), 2.94 MiB | 5.87 MiB/s   Receiving objects:  60% (126/210), 2.94 MiB | 5.87 MiB/s   Receiving objects:  61% (129/210), 2.94 MiB | 5.87 MiB/s   Receiving objects:  62% (131/210), 2.94 MiB | 5.87 MiB/s   Receiving objects:  63% (133/210), 2.94 MiB | 5.87 MiB/s   Receiving objects:  64% (135/210), 2.94 MiB | 5.87 MiB/s   Receiving objects:  65% (137/210), 2.94 MiB | 5.87 MiB/s   Receiving objects:  66% (139/210), 2.94 MiB | 5.87 MiB/s   Receiving objects:  67% (141/210), 2.94 MiB | 5.87 MiB/s   Receiving objects:  68% (143/210), 2.94 MiB | 5.87 MiB/s   Receiving objects:  69% (145/210), 2.94 MiB | 5.87 MiB/s   Receiving objects:  70% (147/210), 2.94 MiB | 5.87 MiB/s   Receiving objects:  71% (150/210), 2.94 MiB | 5.87 MiB/s   Receiving objects:  72% (152/210), 2.94 MiB | 5.87 MiB/s   Receiving objects:  73% (154/210), 2.94 MiB | 5.87 MiB/s   Receiving objects:  74% (156/210), 2.94 MiB | 5.87 MiB/s   Receiving objects:  75% (158/210), 2.94 MiB | 5.87 MiB/s   Receiving objects:  76% (160/210), 2.94 MiB | 5.87 MiB/s   Receiving objects:  77% (162/210), 2.94 MiB | 5.87 MiB/s   Receiving objects:  78% (164/210), 2.94 MiB | 5.87 MiB/s   Receiving objects:  79% (166/210), 2.94 MiB | 5.87 MiB/s   Receiving objects:  80% (168/210), 2.94 MiB | 5.87 MiB/s   Receiving objects:  81% (171/210), 2.94 MiB | 5.87 MiB/s   Receiving objects:  82% (173/210), 2.94 MiB | 5.87 MiB/s   Receiving objects:  83% (175/210), 2.94 MiB | 5.87 MiB/s   Receiving objects:  84% (177/210), 2.94 MiB | 5.87 MiB/s   Receiving objects:  85% (179/210), 2.94 MiB | 5.87 MiB/s   Receiving objects:  86% (181/210), 2.94 MiB | 5.87 MiB/s   remote: Total 210 (delta 89), reused 0 (delta 0)[K
Receiving objects:  87% (183/210), 2.94 MiB | 5.87 MiB/s   Receiving objects:  88% (185/210), 2.94 MiB | 5.87 MiB/s   Receiving objects:  89% (187/210), 2.94 MiB | 5.87 MiB/s   Receiving objects:  90% (189/210), 2.94 MiB | 5.87 MiB/s   Receiving objects:  91% (192/210), 2.94 MiB | 5.87 MiB/s   Receiving objects:  92% (194/210), 2.94 MiB | 5.87 MiB/s   Receiving objects:  93% (196/210), 2.94 MiB | 5.87 MiB/s   Receiving objects:  94% (198/210), 2.94 MiB | 5.87 MiB/s   Receiving objects:  95% (200/210), 2.94 MiB | 5.87 MiB/s   Receiving objects:  96% (202/210), 2.94 MiB | 5.87 MiB/s   Receiving objects:  97% (204/210), 2.94 MiB | 5.87 MiB/s   Receiving objects:  98% (206/210), 2.94 MiB | 5.87 MiB/s   Receiving objects:  99% (208/210), 2.94 MiB | 5.87 MiB/s   Receiving objects: 100% (210/210), 2.94 MiB | 5.87 MiB/s   Receiving objects: 100% (210/210), 3.06 MiB | 6.01 MiB/s, done.
Resolving deltas:   0% (0/89)   Resolving deltas:   4% (4/89)   Resolving deltas:   7% (7/89)   Resolving deltas:  11% (10/89)   Resolving deltas:  12% (11/89)   Resolving deltas:  13% (12/89)   Resolving deltas:  17% (16/89)   Resolving deltas:  30% (27/89)   Resolving deltas:  34% (31/89)   Resolving deltas:  40% (36/89)   Resolving deltas:  42% (38/89)   Resolving deltas:  46% (41/89)   Resolving deltas:  47% (42/89)   Resolving deltas:  49% (44/89)   Resolving deltas:  56% (50/89)   Resolving deltas:  57% (51/89)   Resolving deltas:  58% (52/89)   Resolving deltas:  60% (54/89)   Resolving deltas:  61% (55/89)   Resolving deltas:  64% (57/89)   Resolving deltas:  67% (60/89)   Resolving deltas:  70% (63/89)   Resolving deltas:  71% (64/89)   Resolving deltas:  79% (71/89)   Resolving deltas:  82% (73/89)   Resolving deltas:  83% (74/89)   Resolving deltas:  84% (75/89)   Resolving deltas:  86% (77/89)   Resolving deltas:  87% (78/89)   Resolving deltas:  89% (80/89)   Resolving deltas:  98% (88/89)   Resolving deltas: 100% (89/89)   Resolving deltas: 100% (89/89), done.
alongo5@g7-08:~/projects$ ls
cs240
alongo5@g7-08:~/projects$ cd ~
alongo5@g7-08:~$ ln -s projects/cs240/ [K[K .
alongo5@g7-08:~$ ls
cs120  Desktop	  Downloads  Pictures  Public	  tmp
cs240  Documents  Music      projects  Templates  Videos
alongo5@g7-08:~$ cd git[K[K[K~/git-repos/cd[Ks250[K[K40
bash: cd: /home/alongo5/git-repos/cs240: No such file or directory
alongo5@g7-08:~$ ls
cs120  Desktop	  Downloads  Pictures  Public	  tmp
cs240  Documents  Music      projects  Templates  Videos
alongo5@g7-08:~$ cd cs240
alongo5@g7-08:~/cs240$ ls
announce.html  docs	      hws	  labs	    README.md
announce.umt   exams-quizzes  index.html  misc	    slides
assets	       exercises      index.umt   projects  umt.make
alongo5@g7-08:~/cs240$ exi[K[K[Kcd ~
alongo5@g7-08:~$ cd ~/g[K[K[K[K[K[Kls
cs120  Desktop	  Downloads  Pictures  Public	  tmp
cs240  Documents  Music      projects  Templates  Videos
alongo5@g7-08:~$ cd projects/
alongo5@g7-08:~/projects$ ls
cs240
alongo5@g7-08:~/projects$ cd ..
alongo5@g7-08:~$ mkdir git0[K-repos
alongo5@g7-08:~$ cd git-repos/cs240
bash: cd: git-repos/cs240: No such file or directory
alongo5@g7-08:~$ git[K[K[Kcd [K[K[Kcd git-repos/
alongo5@g7-08:~/git-repos$ mkdir cs240
alongo5@g7-08:~/git-repos$ cd cs240/
alongo5@g7-08:~/git-repos/cs240$ git pull
fatal: not a git repository (or any parent up to mount point /import)
Stopping at filesystem boundary (GIT_DISCOVERY_ACROSS_FILESYSTEM not set).
alongo5@g7-08:~/git-repos/cs240$ cd ../..
alongo5@g7-08:~$ ls
cs120  Desktop	  Downloads  Music     projects  Templates  Videos
cs240  Documents  git-repos  Pictures  Public	 tmp
alongo5@g7-08:~$ rm -rf git-repos/
alongo5@g7-08:~$ cd cd[Ks240
alongo5@g7-08:~/cs240$ ls
announce.html  docs	      hws	  labs	    README.md
announce.umt   exams-quizzes  index.html  misc	    slides
assets	       exercises      index.umt   projects  umt.make
alongo5@g7-08:~/cs240$ git pull
Warning: Permanently added the ECDSA host key for IP address '128.226.114.200' to the list of known hosts.
/home/alongo5/.bashrc: line 1: /home/umrigar/cs240/bin/student.profile: Permission denied
Already up to date.
alongo5@g7-08:~/cs240$ cd ~/
alongo5@g7-08:~$ vimvim[K[K[K crontab -e
[?1000h[?2004h[?1049h[22;0;0t[?1h=[?2004h[1;24r[?12h[?12l[22;2t[22;1t[?25l[24;1H"crontab" [New File][2;1H▽[6n[2;1H  [1;1H[>c]10;?]11;?[24;1H
Entering Ex mode.  Type "visual" to go to Normal mode.[?25h
:P+q436f\P+q6b75\P+q6b64\P+q6b72\P+q6b6c\P+q2332\P+q2334\P+q2569\P+q2a37\P+q6b31\[?1000l[?1006h[?1002h[?1006l[?1002l[?1006h[?1002hvisual
[?25l[97m[41mE749: empty buffer[?1006l[?1002l[?2004l[?1006h[?1002h[?2004h[27m[23m[29m[m[H[2J[2;1H[94m~                                                                               [3;1H~                                                                               [4;1H~                                                                               [5;1H~                                                                               [6;1H~                                                                               [7;1H~                                                                               [8;1H~                                                                               [9;1H~                                                                               [10;1H~                                                                               [11;1H~                                                                               [12;1H~                                                                               [13;1H~                                                                               [14;1H~                                                                               [15;1H~                                                                               [16;1H~                                                                               [17;1H~                                                                               [18;1H~                                                                               [19;1H~                                                                               [20;1H~                                                                               [21;1H~                                                                               [22;1H~                                                                               [23;1H~                                                                               [m[24;63H0,0-1[9CAll]2;crontab (~) - VIM]1;crontab[1;1H[?25h[?25l[24;53Hi[1;1H[24;53H [1;1H[24;1H[1m-- INSERT --[m[24;63H[K[24;63H0,1[11CAll[1;1H[?25h[24;1H[K[1;1H[?25l[24;53H^[[1;1H[24;53H  [1;1H[24;63H0,0-1[9CAll[1;1H[?25h[?25l[24;53H:[1;1H[24;53H[K[24;1H:[?2004h[?25hq[?25l[?25h[?25l[?1006l[?1002l[?2004l]2;Terminal - ]1;Terminal - [23;2t[23;1t[22;2t[22;1t[23;2t[23;1t[24;1H[K[24;1H[?2004l[?1l>[?25h[?1049l[23;0;0talongo5@g7-08:~$ ECU[K[KDITOR [K=vim crontab =[Ke[K-e
crontabs: No such file or directory
alongo5@g7-08:~$ cd projects/
alongo5@g7-08:~/projects$ ls
cs240
alongo5@g7-08:~/projects$ cd s[Kcs240/
alongo5@g7-08:~/projects/cs240$ ls
announce.html  docs	      hws	  labs	    README.md
announce.umt   exams-quizzes  index.html  misc	    slides
assets	       exercises      index.umt   projects  umt.make
alongo5@g7-08:~/projects/cs240$ git pull
/home/alongo5/.bashrc: line 1: /home/umrigar/cs240/bin/student.profile: Permission denied
Already up to date.
alongo5@g7-08:~/projects/cs240$ cd ~
alongo5@g7-08:~$ cd cs240
alongo5@g7-08:~/cs240$ git log -N
fatal: unrecognized argument: -N
alongo5@g7-08:~/cs240$ git log -5
[?1h=[33mcommit 8d6dd352014a55daef6e897d54d5bc33650ca50f[m[33m ([m[1;36mHEAD -> [m[1;32mmaster[m[33m, [m[1;31morigin/master[m[33m, [m[1;31m[m [33m[m[33m[m[1;36m[m[1;32m[m[33m[m[1;31m[m[33m[m[1;31morigin/HEAD[m[33m)[m[m
Author: zerksis umrigar <umrigar@binghamton.edu>[m
Date:   Thu Jan 23 13:40:58 2020 -0500[m
[m
    added abet requirements to syllabus[m
[m
[33mcommit 24681db1cd13af495d8c1511f77123e5d91ed1dd[m[m
Author: zerksis umrigar <umrigar@binghamton.edu>[m
Date:   Thu Jan 23 08:17:24 2020 -0500[m
[m
    added grading guidelines[m
[m
[33mcommit b28da302c11169a1a76ebab0b25099bb8241c34b[m[m
Author: zerksis umrigar <umrigar@binghamton.edu>[m
Date:   Wed Jan 22 22:01:19 2020 -0500[m
[m
    update syllabus and lab0 with TA info[m
[m
[33mcommit 8d242d7ee425f9c85f96bb6923179e7390091716[m[m
Author: zerksis umrigar <umrigar@binghamton.edu>[m
Date:   Wed Jan 22 12:34:04 2020 -0500[m
[m
:[K[K    tweaks[m
:[K[K[m
:[K[K[33mcommit e1347fe43738124771013ec1a789ec5e3d9ae284[m[m
:[K[KAuthor: zerksis umrigar <umrigar@binghamton.edu>[m
:[K[KDate:   Wed Jan 22 11:34:26 2020 -0500[m
:[K[K[m
:[K[K    set up for first class[m
:[K[K[K[7m(END)[27m[K[K[K[7m(END)[27m[K[K[K[7m(END)[27m[K[K[K[7m(END)[27m[K[K[K[7m(END)[27m[K[K[K[7m(END)[27m[K[K[K[7m(END)[27m[K[K[K[7m(END)[27m[K[K[K[7m(END)[27m[K[K[K[7m(END)[27m[K[K [KESCESC[K::[K[7m(END)[27m[K[K[HM[m
[HM    added abet requirements to syllabus[m
[HM[m
[HMDate:   Thu Jan 23 13:40:58 2020 -0500[m
[HMAuthor: zerksis umrigar <umrigar@binghamton.edu>[m
[HM[33m[m[33m[m[1;36m[m[1;32m[m[33m[m[1;31m[m[33m[m[1;31morigin/HEAD[m[33m)[m[m
[HM[33mcommit 8d6dd352014a55daef6e897d54d5bc33650ca50f[m[33m ([m[1;36mHEAD -> [m[1;32mmaster[m[33m, [m[1;31morigin/master[m[33m, [m[1;31m[m[24;1H[K:[K[K[K:[K[K:[K[K[?1l>alongo5@g7-08:~/cs240$ git log labs/lab0/[K.umt
fatal: ambiguous argument 'labs/lab0.umt': unknown revision or path not in the working tree.
Use '--' to separate paths from revisions, like this:
'git <command> [<revision>...] -- [<file>...]'
alongo5@g7-08:~/cs240$ git log labs/lab0.umt[C labs/lab0.umt- labs/lab0.umt[C labs/lab0.umt[1Plabs/lab0.umt3 labs/lab0.umt
fatal: ambiguous argument 'labs/lab0.umt': unknown revision or path not in the working tree.
Use '--' to separate paths from revisions, like this:
'git <command> [<revision>...] -- [<file>...]'
alongo5@g7-08:~/cs240$ cd ~
alongo5@g7-08:~$ ls
cs120  Desktop	  Downloads  Pictures  Public	  tmp
cs240  Documents  Music      projects  Templates  Videos
alongo5@g7-08:~$ cd projects/
alongo5@g7-08:~/projects$ ls
cs240  i240a
alongo5@g7-08:~/projects$ cd ~
alongo5@g7-08:~$ ln -s ~/projects/i240a/ .
alongo5@g7-08:~$ cd ~/s[Kprojects/i240a/
alongo5@g7-08:~/projects/i240a$ ls -a
.  ..  .git  .gitignore  README.md
alongo5@g7-08:~/projects/i240a$ git status -s
alongo5@g7-08:~/projects/i240a$ git status
On branch master
Your branch is up to date with 'origin/master'.

nothing to commit, working tree clean
alongo5@g7-08:~/projects/i240a$ git commit --allow-emptu[Ky "Initial Commit"
error: pathspec 'Initial Commit' did not match any file(s) known to git
alongo5@g7-08:~/projects/i240a$ cd ~
alongo5@g7-08:~$ ls -dl ~/cs240 ~/i240a
lrwxrwxrwx 1 alongo5 alongo5 14 Jan 23 13:42 /home/alongo5/cs240 -> projects/cs240
lrwxrwxrwx 1 alongo5 alongo5 29 Jan 23 14:05 /home/alongo5/i240a -> /home/alongo5/projects/i240a/
alongo5@g7-08:~$ ls -; ~/.ssh/ ~/.cs2[K[K[K[Kcs240 ~/.[Ki240a
ls: cannot access '-': No such file or directory
bash: /home/alongo5/.ssh/: Is a directory
alongo5@g7-08:~$ ls -; ~/.ssh/ ~/cs240 ~/i240a[C[C[1P[1@l
lrwxrwxrwx 1 alongo5 alongo5 14 Jan 23 13:42 /home/alongo5/cs240 -> projects/cs240
lrwxrwxrwx 1 alongo5 alongo5 29 Jan 23 14:05 /home/alongo5/i240a -> /home/alongo5/projects/i240a/

/home/alongo5/.ssh/:
total 16
-rw------- 1 alongo5 alongo5  395 Jan 23 13:19 authorized_keys
-rw------- 1 alongo5 alongo5 1823 Jan 23 13:18 id_rsa
-rw-r--r-- 1 alongo5 alongo5  395 Jan 23 13:18 id_rsa.pub
-rw-r--r-- 1 alongo5 alongo5 1332 Jan 23 13:48 known_hosts
alongo5@g7-08:~$ cd ~/i240a
alongo5@g7-08:~/i240a$ git checkout -b lab0
Switched to a new branch 'lab0'
alongo5@g7-08:~/i240a$ mkdir -p submit
alongo5@g7-08:~/i240a$ mv [K[K[Kexit
^F
Script done on 2020-01-23 14:13:49-05:00 [COMMAND_EXIT_CODE="0"]
